凌寒	Ling Han
巅峰	peak
不灭天经	Undying Heavenly Scripture
龙抬头	Longtaitou Festival
好马不吃回头草	a good man doesn't backtrack
小菜一碟	a piece of cake
太阳从西边出来	hell freezes over
说曹操，曹操到	speak of the devil
乌鸦嘴	jinx
二百五	halfwit, pea-brain
吃一堑，长一智	a fall in the pit, a gain in your wit
睁着眼睛说瞎话	to flout reality, to tell bald-faced lies, to lie through one's teeth
近朱者赤，近墨者黑	one is marked by the company one keeps
物以稀为贵	that which is rare is dear
王婆卖瓜，自卖自夸	every potter praises his own pot
站着说话不腰疼	talk is cheap, to be an armchair quarterback
天下没有不散的筵席	all good things must come to an end
天上掉馅饼	to have something fall into your lap
巧己所不欲，勿施于人	do unto others as you would have them do unto you
睁眼瞎	a bad judge of character
跳进黄河洗不清	to be unable to clear one's name
拍马屁	to suck up to, curry favor, ingratiate
情人眼里出西施	love is blind, beauty is in the eye of the beholder
打酱油	I couldn't care less, that's above my pay grade
不怕一万，就怕万一	one can never be too careful
走着瞧	wait and see
不管三七二十一	to act recklessly, to throw caution to the wind
吃着碗里的，看着锅里的	to be unsatisfied with what one has
钻牛角尖	to split hairs, to go down a dead end
人不可貌相，海水不可斗量	you can't judge a book by its cover
林子大了，什么鸟都有	there are all kinds of fish in the sea
鸡毛蒜皮	trivial, trivalities
鲜花插在牛粪上	a beautiful woman is married to an old/ugly man
醉翁之意不在酒	to have an ulterior motive
猴年马月	god know when, it'll be a cold day in hell when
眼不见为净	what somebody doesn't know/see can't hurt them
姜是老的竦	with experience comes wisdom
得青山在，不怕没柴烧	where's there's life there's hope
拿得起，放得下	to be able to go with the flow
以其人之道还治其人之身	to give someone a taste of their own medicine, to pay back in one's own coin
走桃花运	lucky in love
成事不足，败事有余	incompetent, everything one touches turns to dust
皇上不急太监急	the person involved is calm and collected but observers are very worried
三个臭皮匠，顶个诸葛亮	two heads are better than one
脚踩两只船	to have a foot in both camps
此地无银三白两	telltale sign, methinks the lady doth protest too much
吃不到葡萄就说葡萄酸	sour grapes
心急吃不了热豆腐	more haste less speed
家常便饭	run of the mill, par for the course
癞蛤蟆想吃天鹅肉	to be out of one's league, to want to punch above one's weight
天无绝人之路	there is always a way out
走后门	get in through the back door
瞎猫碰上死耗子	even a broken clock is right twice a day
好汉不吃眼前亏	discretion is the better part of valor, you have to know when to hold'em and when to fold'em
解铃还须系铃人	he that hides can find
肥水不流外人田	one does not allow benefits created by one's own work to accrue to others
心有余而力不足	run out of steam
不分青红皂白	indiscriminate
睁一只眼，闭一只眼	to turn a blind eye
破罐子破摔	a vicious cycle
种瓜得瓜，种豆得豆	you reap what you sow
萝卜白菜，各有所爱	different strokes for different folks
狗嘴里吐不出象牙	what can you expect from a hog but a grunt
三天打鱼，两天晒网	to blow hot and cold, lack perserverance and continuity
一朝被蛇咬，十年怕井绳	once bitten twice shy
英雄难过美人关	no man can resist the charms of a beautiful woman
刀子嘴，豆腐心	to be a softie at hear, someone's bark is worse than their bite
一失足成千古恨	one false step brings everlasting grief
哪壶不开提哪壶	rub someone's nose in it
炒鱿鱼	to can someone, to give someone a pink slip
人往高处走，水往低处流	it is in man's nature to strive for better
说得比唱得好听	to speak eloquently but untruthfully
强扭的瓜不甜	you can lead a horse to water but you can't make him drink
老掉牙	tired old
搬起石头砸自己的脚	to shoot oneself in the foot
卖关子	to leave someone hanging
一分钱一分货	you get what you pay for
九牛二虎之力	a Herculean effort
敬酒不吃吃罚酒	to acquiesce to something after having refused someone's first overture
躲得过初一，躲不过十五	you can't avoid something forever, you can't keep something up forever
吃香的，喝辣的	to live in the lap of luxury
小儿科	child's play, easy
一个巴掌拍不响	it takes two to tango
牛头不对马嘴	incongrous, neither here not there
以小人之心，度君子之腹	to project one's shortcomings on someone
车到山前必有路	we'll cross that bridge when we come to it
鸡蛋里挑骨头	to nitpick, to find quarrel in a straw
吃不了兜着走	to be unable to bear the consequences of failure
打肿脸充胖子	to puff oneself up at one's own cost
三十六计走为上	to get out while the going's good
当耳旁风	to roll off like water off a duck's back
恨铁不成钢	expect better from someone
你走你的阳关道，我过我的独木桥	let's go our separate ways
过了这个村，就没这个店	it's now or never, opportunity seldom knocks twice
抱佛脚	to cram, fair weather atheists turn to god in a pinch
有钱能使鬼推磨	money talks
有其父必有其子	like father like son, the apple doesn't fall far from the tree
不见棺材不落泪	to hold out hope until faced with the grim reality
三长两短	god forbid anything should happen to someone
纸包不住火	the truth always comes out, there is no concealing the truth
好戏在后头	the best is yet to come, you ain't seen nothing yet
吹牛皮	brag, to blow smoke
欲速则不达	more haste less speed
家家有本难念的经	we all have our burdens to bear, every family has its hardships
墙头草	fence sitter
替罪羊	sacrificial lamb, scapegoat
近水楼台先得月	to enjoy the benefits of a favorable position
小巫见大巫	to pale in comparison with, doesn't hold a candle to
过河拆桥	to kick someone to the curb when they've outlived their usefulness.
一不做，二不休	in for a penny in for a pound
以牙还牙，以眼还眼跑了	an eye for an eye and a tooth for a tooth
和尚跑不了庙	you can run but you can't hide
绿帽子	cuckold
识时务者为俊杰	he who understands the times is a wise man
井水不犯河水	to stay in one's own lane,mine one's own business
一棵树上吊死	to be inflexible and stubborn
放鸽子	to stand someone up, to leave someone in the lurch
一步一个脚印	to take something one step at a time
上梁不正下梁歪	a crooked stick will have a crooked shadow
不入虎穴，焉得虎子	nothing good comes without risk
赔了夫人又折兵	to suffer a double loss
有心栽花花不长，无心插柳柳成荫	to unknowingly benefit from an unexpected course of events
八字还没一撇	it hasn't even begun
有眼不识泰山	to entertain angels unawares, to fail to recognize a formidable/famous person
出气筒	punching bag
八九不离十	close to the mark, not far off
无风不起浪	there's no smoke without fire
得便宜卖乖	to not admit that one has received a benefit
不是省油的灯	a real piece of work
家丑不可外扬	don't wash dirty linen in public
背黑锅	to take the rap, to take the blame, be left holding the bag
兔子不吃寓边草	even a villain doesn't harm the next door neighbors
铁饭碗	a cradle-to-grave job
冰冻三尺，非一日之寒	Rome wasn't built in a day
远亲不如近邻	better a close neighbor than a distant brother
下马威	opening gambit, take someone a notch down, establishing an imposing air or advantageous position for oneself
天下乌鸦一般黑	they're all the same
不到黄河心不死	it's not over 'til it's over
狗急了跳墙	despair fives courage even to a coward
狗眼看人低	to have one's nose in the air, to be stuck-up
只许州官放火，不许百姓点灯	one may steal a horse while another may not look over a hedge
偷鸡摸狗	to pilfer, to philander
死马当活马医	to make a Hail Mary effort
新官上任三把火	to make drastic changes to an organization upon taking charge
对号入座	to make a connection
十万八千里	worlds apart
露马脚	to let the cat out of the bag
公说公有理，婆说婆有理	each side believes it is correct, both sides have their merits
上刀山，下火海	come hell or high water
打退堂鼓	to beat a retreat
磨刀不误砍柴工	a beard lathered is half shaved
风马牛不相及	as different night and day, to be as different as chalk and cheese
一山不容二虎	two tigers cannot share one mountain
里揉不得沙子	to not let things slide
三下五除二	in no time (flat),deftly
泼冷水	to pour cold water on
杀鸡给猴看	to throw the book at someone to set an example
生米做成熟饭	the die is cast, what's done is done
初生牛犊不怕虎	youth knows no fear
铁公鸡	miser, tightwad
无事不登三宝殿	one never visits unless they need something
马后炮	to be wise after the fact
掉链子	to fumble the ball
纸老虎	paper tiger
狐狸精	vixen, siren
丑话说在前头	let's be candid here, let's get the unpleasant/unpleasantness out of the way
半路杀出个程咬金	someone threw a wrench in the works
麻雀虽小，五脏俱全	even if something is small it can still contain the essentials
虎毒不食子	even a monster would not hurt its own children
小不忍则乱大谋	a little impatience will spoil great plans
打狗还得看主人	every action has consequences, when one beats a dog one must answer to its master
万事俱备，只欠东风	to be prepared but lack the crucial element
不管黑猫白猫，会捉老鼠就是好猫	it does not matter whether a cat is black or white so long as it catches mice
真金不怕火炼	true blue will never stain
狗改不了吃屎	the fox may grow grew but never good
杀手锏	ace in the hole, trump card
饥不择食	beggars can't be choosers
对事不对人	it's nothing personal
皮笑肉不笑	fake smile
双刃剑	double-edged sword
热脸貼冷屁股	to have someone not give you the time of day
好了伤疤忘了疼	once on shore one prays no more
醋坛子	jealous lover
君子之交淡如水	the friendship between gentlemen appears indifferent but is pure like water
三个和尚没水吃	everybody's business is nobody's business
赶鸭子上架	to force someone to put a square peg into a round hole
小白脸	pretty boy
放长线，钓大鱼	to play the long game
依葫芦画瓢	to follow suit
隔墙有耳	walls have ears
巧妇难为无米之炊	you can't make bricks without straws
不是吃素的	to be someone not to be trifled with
嫁鸡随鸡，嫁狗随狗	a woman should stand by her man
打开天窗说亮话	to lay one's cards on the table
人算不如天算	the best laid plans of mice and men often go awry, man proposes god disposes
小动作	a cheap shot, a cheap trick
远水解不了近渴	while the grass grows the horse starves
占着茅坑不拉屎	to be a dog in the manger
碰一鼻子灰	to get the cold shoulder, to be left out in the cold
死猪不怕开水烫	the situation is already so bad that to make it worse makes no real difference
换汤不换药	putting old wine in new bottles
救命稻草	a straw to clutch at
明枪易躲，暗箭难防	better an open enemy than a false friend, an open foe may prove a curse but a pretend friend is even worse
谋事在人，成事在天	man proposes god diparesis's all in god's hands now
三个女人一台戏	three women make a market four a fair
有鼻子有眼	a word picture, a vivid description
枪打出头鸟	the hunter will shoot the bird that sticks out
碰钉子	to be rebuffed
蹬鼻子上脸	to go too far
吃豆腐	to take advantage of a woman
眉毛胡子一把抓	to tackle everything all at once, to deal with everything in one fell swoop
偷鸡不成反蚀把米	to go out for wool and come back shorn
众人拾柴火焰高	little things add up, many hands make light work
快刀斩乱麻	to cut the Gordian knot
吃软饭	freeloader, to freeload
一着不慎，满盘皆输	one false move may lose the game
听风就是雨	to jump to conclusions from insignificant evidence
鸿门宴	ambush, treacherous plot
吃哑巴亏	to bite one's tongue, to hold one's tongue
眼中钉、肉中刺	a thorn in the side
舍不得孩子套不住狼	you have to spend money to make money
挂羊头、卖狗肉	to bait and switch, to cry wine and sell vinegar
煮熟的甲鸟子飞了	to slip though one's fingers
常在河边走，哪有不湿鞋	touch pitch and you shall be defiled
三脚猫	dilettantish, middling
吃闭门羹	to be left out in the cold, to get the cold shoulder
三十年河东，三十年河西	change is the only constant, the wheel of fortune turns
土包子	bumpkin, boor, hillbilly
树大招风	the winds howl around the highest peaks
酒逢知己千杯少	for a good friend a thousand toasts are too few
当一天和尚撞一天钟	to go through the motions
是骡子是马拉出来遛遛	actions speak louder than words, it's time to see what someone is worth
一个鼻孔出气	to be hand in glove
身在曹营心在汉	to not have one's heart in something
瘦死的骆驼比马大	a starving camel is still bigger than a horse
树欲静而风不止	for a situation to takes it own course regardless of someone's wishes
丑媳妇早晚也得见公婆	one is unable to avoid an unpleasant experience forever
胜者王侯败者贼	winning isn't everything it's the only thing, history is written by the victors
下三烂	low-life, low-down
上了贼船	to get in too deep, to cross the Rubicon
病急乱投医	desperate times call for desperate measures, a drowning man will clutch at a straw
打如意算盘	to engage in wishful thinking
龙生龙，凤生凤	like father like son, like mother like daughter
不看僧面看佛面	for someone's sake
雷声大、雨点小	all talk no action
脸红脖子粗	flushed with excitement/agitation, to be red in the face
一棍子打死	to throw the baby out with the bathwater
拿鸡蛋碰石头	to pick a losing battle
没有不透风的墙	two may keep counsel putting one away
人怕出名猪怕壮	fame can be a double-edged sword
山中无老虎，猴子称大王	when the cat's away the mice will play
杀鸡焉用宰牛刀	you don't need a sledgehammer to crack a nut
大树底下好乘凉	follow closely behind heavy-laden wagons
跑龙套	to be a small player, act as a utility man
七大姑，趴大姨	extremely distant relatives
一是一，二十二	to call a spade a spade
多个朋友多条路	the more friends you have the more options you have in life
下台阶	to give someone an out
打小算盘	to act in one's own self-interest
坐山观虎	sit this one out and reap the spoils later
斗羊毛出在羊身上	there's no such thing as a free lunch
一口吃成个胖子	to wave a magic wand and get what one wants
屋漏偏逢连阴雨	when it rains it pours
老油条	wily old fox, slippery one
捅马蜂窝	to stir up a hornet's nest
小意思	not a big deal, a token
倒打一耙	to play the blame game
陈芝麻，烂谷子	idle chatter
一条龙	from soup to nuts
四两拨千斤	to solve a big issue with little effort
前怕狼，后怕虎	to be afraid to commit oneself
吃水不忘挖井人	when drinking water don't forget those who dug the well
有仇不报非君子	a real man must settle his scores
不倒翁	a tumbler
干打雷，不下雨	to talk the talk but not walk the walk, all bark and no bite
鸡飞狗跳	in a tizzy
事后诸葛亮	hindsight is 20-20
落水狗	one who is down on their luck
板上钉钉	a sure bet, a shoo-in
一碗水端平	to be impartial, to take an impartial approach
烫手的山芋	a hot potato
笑掉大牙	to laugh one's head off
一回生，二回熟	a stranger is just a friend you haven't met yet
鱼与熊掌不可得兼	one can't have everything in life
咸鱼翻身	to give a new lease on life
一根绳上的蚂蚱	to be in something together
趟浑水	to intentionally get involved in a messy situation
狗腿子	lackey, henchman, lapdog
用在刀刃上	to employ limited resources where they are needed most
鸡飞蛋打	to come up empty-handed
胳膊扭不过大腿	the weak cannot contend with the strong
饱汉不知饿汉饥	the wearer knows best where the shoe pinches
笑面虎	a wolf in sheep's clothing
二	clueless
给力	awesome, exciting
母老虎	shrew
五十步笑百步	the pot calling the kettle black
门外汉	a layman
前人栽树，后人乘凉	for posterity's sake, walnuts and pears you plant for your heirs
烂泥扶不上墙	to wash a pig is to waste both water and soap
关公面前耍大刀	to teach one's grandmother how to suck eggs
高不成，低不就	to not be good enough to get what one wants but unwilling to pursue something befitting one's talents
胳膊肘往外扭	to side with outsiders instead of one's own people
长痛不如短痛	it's better to deal with painful things quickly, it's better to just rip the Band-Aid off now
酒香不怕巷子深	good wine needs no bush
一条路走到黑	to be as stubborn as a mule
不是鱼死，就是网破	it's either him or me
冰山一角	the tip of the iceberg
身体是革命的本钱	good health is a prerequisite for work
说风凉话	to crack wise
紧箍咒	to tug on the yoke, a yoke on the shoulders
唱双簧	a carefully choreographed dance, to scheme with someone
开空白支票	to make a promise one cannot keep, to write a check one can't cash
保护伞	something providing legal or political cover for someone
一个萝卜一个坑	each has his own task and there's nobody to spare
狗咬狗	dogfight
唱高调	to posture
打水漂	to make ducks and drakes of
开小差	to let one's mind wander, to zone out
两面派	double-dealer, double dealing
一盘散沙	to be in state of disunity
和稀泥	to paper over something
敲竹杠	to fleece, highway robbery
扯后腿	to hold someone back
穿小鞋	to stack the deck against someone
给他一点颜色看看	to take someone down a peg, to fix someone's wagon
天高皇帝远	when one is far away from authority the powers that be will not intervene
拣软柿子捏	to pick on an easy target
打马虎眼	to play dumb, to demur
千里马	wunderkind, prodigy
打擦边球	to push the envelope
摸着而头过河	to cross the river by touching stones
半路出家	mid-life career change
老狐狸	sly old fox
一窝蜂	a swarm
开夜车	to burn the midnight oil
手心手背都是肉	a tough call
缩头乌龟	a chicken, a coward, a scaredy cat
走过场	to go through the motions, to do something as a formality
做文章	to seize on, to make an issue of something
吃大锅饭	to be compensated without regard to performance
戴高帽	to oversell something
秋后算账	revenge is a dish best served cold
僧多粥少	too many boats chasing too few fish
坐冷板凳	to be sidelined
不当家不知柴米贵	if one is not in someone else's situation one cannot understand that person's troubles
红眼病	jealousy, the green-eyed monster
葫芦里卖的是什么药	to have something up one's sleeve
三句话不离本行	to hardly be able to talk about anything other than one's work
糖衣炮弹	Trojan Horse
树倒猢狲散	rats leave a sinking ship
硬骨头	a tough nut to crack, one tough cookie
二虎相争，必有一伤	when two tigers clash, one is sure to get hurt
拆东墙，补西墙	to rob Peter to pay Paul
大鱼吃小鱼	the law of the jungle
狐狸尾巴露出来了	to show one's true colors, the jig is up
开绿灯	to give the go-ahead
歪瓜裂枣	a troll
小辫子	chink in one's armor
一头雾水	at a loss
隔行如隔山	different professions are different worlds
一亩三分地	personal fief
成也萧何，败也萧何	one's successes and failures are both due to the same person
大水冲了龙王庙	friendly fire
乱弹琴	to speak or act without sound reason
挤牙膏	to draw something out, to be like pulling teeth
墙倒众人推	everyone kicks a man who is down
莫须有	groundless, trumped-up
拿鸡毛当令箭	to use a made-up directive to order people around
捅破窗户纸	to affirm an open secret, to address the elephant in the room
三字经	curse
苍蝇不叮无缝的蛋	to bring bad things upon oneself as a result of one's bad character
大跌眼镜	to have one's jaw drop, to be slack-jawed
说一千，道一万	there are no two ways about it
绊脚石	stumbling block
过五关、斩六将	to overcome great challenges and have the glory to show for it
求爷爷、告奶奶	to go around begging for help
羡慕嫉妒恨	to be green with envy
打掉门牙往肚里咽	to bite one's tongue
唱对台戏	to steal someone's thunder, to take the wind out of someone's sails
分一杯羹	to take one's share of the loot
变色龙	chameleon
独木不成林	a single tree does not a forest make
既生瑜，何生亮	if god made someone so excellent why did he make someone even better
撂挑子	to quit one's job, to shirk one's responsibilites
敲门砖	prerequisite for
试金石	touchstone, standard or criterion by which something is judged
火烧眉毛	the chips are down, pressing
空手套白狼	to gain something without risking anything of one's own
一瓶子不满，半瓶子晃荡	empty barrels make the most noise
脱了裤子放屁	as useless as tits on a bull
借东风	to ride the wave
白开水	vanilla
鲤鱼跳龙门	to get one's big break, carp jumping the dragon gate, advance to a point at which one's success is guaranteed
强龙压不住地头蛇	you can't beat someone on their home turf
这山望着那山高	the grass is greener on the other side
光脚的不怕穿鞋的	he who is down need fear no fall
不成功，便成仁	to win or die trying
滚刀肉	real piece of work
久病成良医	prolonged illness makes the patient a good doctor
枕边风	pillow talk
一锤子买卖	to skin the sheep
横挑鼻子竖挑眼	to do one's utmost to find the problems where there are none
唱空城计	to bluff, to not be at home
一刀切	cookie-cutter
旧瓶装新酒	new content in an old form
两面三刀	two-faced, double-dealing
一把钥匙开一把锁	there is a key for every lock
打一巴掌，给个甜枣	to throw someone a bone, to use the carrot and stick approach
先君子后小人	let's not let this get ugly
尺有所短，寸有所长	no one is perfect but no one is worthless either
出来混的，总要还的	chickens come home to roost
画虎不成反类犬	(to try to emulate something beyond one's ability and) fall flat on one's face
大意失荆州	to suffer a serious setback as the result of a careless mistake
卸磨杀驴	to kick someone to the curb when they've outlived their usefulness
躺着都中枪	to get caught in the crossfire
脚正不怕鞋歪	an honest man fears no gossip
有奶就是娘	to sell one's allegiance to the highest bidder
肉烂在锅里	it's all in the family
说你胖你就喘	flattery like perfume should be smelled not swallowed
擦屁股	to clean up someone's mess
皇帝女儿不愁嫁	sitting pretty
一朝天子一朝亞	new leaders appoint new counsellors
活人让尿憋死	to not be adaptable
走马灯	incessant turnover of personnel, revolving door, musical chairs
花无白日红	nothing good lasts forever
东风压倒西风	the good guys win
岁月是把杀猪刀	time isn't kind to anyone
丁是丁，卯是卯	to be meticulous
多年的媳妇熬成婆	to have paid one's dues and get what one deserves
强将手下无弱兵	there are no poor soldiers under an able general
头痛医头，脚痛医脚	to slap a Band-Aid on something
拉不出屎来怨茅房	a good carpenter doesn't blame his tools
东方不亮西方亮	while something isn't workable in one place it might be workable somewhere else
老牛拉破车	to trundle along
放卫星	to talk the talk,to talk big
鸡同鸭讲	whistling in the wind
一锅端	to be wiped out all at once
老皇历	anachronistic,old news
家花没有野花香	the grass is always greener (on the other side of the fence)
又想当婊子又想立牌坊	to want to be able to do immortal things while maintaining a good name
遮羞布	a fig leaf
耍花枪	to toy with someone
又要马儿跑，又要马儿不吃草	to have one's cake and eat it too
牛不喝水强按头	to impose one's will on someone
摆乌龙	made a mistake,to put one's foot in it
各打五十大板	to punish both parties equally without considering guilt
一个将军一个令	new lords new laws
抱大腿	to cozy up to someone powerful
砸了锅	to drop the ball
会哭的孩子有奶吃	the squeaky wheel gets the grease,those who complain the loudest get the most attention
二一添作五	go fifty-fifty,to split something down the middle
风一阵，雨一阵	to flit from one thing to another
剃头挑子一头热	not having any of it
远来的和尚会念经	all that is foreign must be better
揪辫子	to seize on someone's shortcomings,to get one's hooks into someone
小姐的身子丫鬟的命	a good lady with bad fortune
只见树木，不见森林	to not see the forest for the trees
屁股决定脑袋	one's position determines one's views and behavior
兔子尾巴长不了	something's days are numbered
骑马找马	to look for another job while keeping one's current position
敲锣边儿	to stir the pot
扣帽子	to paint someone as something,to call someone names
拨出萝卜带出泥	one thing brings about another
满嘴跑火车	to blow smoke,to be full of it
温水煮青蛙	to boil the frog slowly
万金油	panacea,jack of all trades
树挪死，人挪活	people unlike trees thrive on change
按下葫芦起了瓢	to be like Whac-A-Mole
到什么山唱什么歌拔	to change one's tune when talking to different people
根汗毛比腰粗	to be significantly richer or more powerful than others
阎王好见，小鬼难搪	getting past the gatekeeper is the hard part
不见兔子不撒鹰	to not commit oneself until success is certain
当面锣，对面鼓	to has things out in the open
眼大肚子小	to have eyes bigger than one's stomach
浅水养不了大鱼	a big fish needs a big pond
吃别人嚼过的馍不香	if you're not the first you're the last
起大早，赶晚集	first off the blocks but last over the line
打不着狐狸惹身骚	to wake a sleeping giant
多面手	polymath,a renaissance man/woman
鸟枪换炮	to be moving on up
矬子里拔将军	in the land of the blind the one-eyed man is king,the best house in a bad neighborhood,to pick the best out of a bad group
给个棒槌就当针	to take something too literally or seriously
捧臭脚	to lick someone's boots
咬人的狗不露齿	beware of a silent dog and still water
炒冷饭	to rehash
一只羊是赶，一群羊也是放	what's one more
虱子多了不咬，账多了不愁	worry is interest paid on trouble before it is due
攒鸡毛，凑掸子	quantity does not make up for inferior quantity
骑脖子拉屎	to treat someone like garbage
指着和尚骂秃子	thinly veiled criticism
蚂蚱也是肉	a buck is a buck
背着抱着一般沉	six of one half a dozen of the other
一言堂	an area where one person's words goes
乱拳打死老师傅	an inexperienced person defeats a master by throwing out the rules of traditions
端起碗来吃肉，放下筷子骂娘	to drink the ocean and then call it salty
出头的椽子先烂	the nail that sticks out gets hammered down
一马勺坏一锅	one bad apple spoils the barrel
终日打雁，让雁啄了眼	the hunter becomes the hunted
老鸹嫌猪黑	it's the pot calling the kettle black
别人牵驴你拨橛	to get caught holding the bag
仔卖爷田不心疼	to sell one's birthright for a mess of pottage
萝卜快了不洗泥	the hasty bitch brings forth blind puppies
接地气	grounded, down to earth
装逼	posture
牛逼	impressive, awesome
异世	alternate world
太古	primordial
上古	ancient
打量	sized up
穿越	transmigrate
紧接着	right on the heels of
放在心上	take it to heart
暗暗恼怒	seething inside
茶杯	teacup
丰满	voluptuous
真视之眼	Eye of Truth
凌寒	Ling Han
黑塔	Black Tower
破虚境	Shattering Void Tier
小塔	Small Tower
吸血元金	Blood Sucking Origin Gold
兔爷	Uncle Rabbit
惜生剑	Revere Life Sword
器阁	Tool Pavilion
龙牙剪	Dragon Fang Shears
神识	divine sense
源力	Source Power
雷火大帝	Heavenly Emperor of Thunder and Fire
不动明王金身	Immovable Deity Metal Body
覆地印	Earth Overturning Seal
冰龙轰地阵	Ice Dragon Ground Blast Formation
尸二	Corpse Two
大凌朝	Great Ling Empire
惜生剑	Revere Life Sword
龙血霸王参	Dragon's Blood Tyrant Ginseng
尸大	Corpse Boss
千尸宗	Thousand Corpse Sect
战力	battle prowess
元力	Origin Power
天人境	Heaven Tier
化神境	Deity Transformation Tier
不灭天经	Indestructible Heaven's Scroll
黄泉池	Netherland Spring
紫月皇朝	Purple Moon Empire
国势	power of the nation
太阴王	Lunar King
寒风城	Cold Wind City
赫连寻雪	Helian Xunxue
寻金鼠	Gold-Seeking Rat
虎妞	Hu Niu
神台境	Spiritual Pedestal Tier
诅咒之瓶	Vial of Curses
生花境	Flower Blossom Tier
鬼仙步	Ghostly Immortal Steps
雷动九天	Thunderclap Ninth Heaven
不灭真液	Indestructible True Fluid
翼双双	Yi Shuangshuang
九龙霸体术	Nine Dragons Tyrant Body Art
灭龙星辰箭	Annihilating Dragon Star Arrow
绝刀	Absolute Saber
徐修然	Xu Xiuran
冬灵儿	Dong Linger
剑帝	Sword Emperor
落日刀皇	Setting Sun Saber Emperor
天凤神女	Heavenly Phoenix Divine Maiden
凌见雪	Ling Jianxue
涌泉境	Gushing Spring Tier
天凤神女	Heavenly Phoenix Divine Maiden
鬼龙窟	Ghostly Dragon Cave
真龙血石	True Dragon's Blood Stone
龙威	dragon's might
亚龙	alternative dragon
天星王	Heavenly Astral King
天剑宗	Heaven's Sword Sect
铸器师	Weaponsmiths
沉香谷	Sunken Fragrance Valley
生命禁区	Life-Restricted Area
血蠕虫	Bloodworm
鬼龙窟	Ghost Dragon Cave
八荒阿鼻剑法	Desolate Hell Sword Technique
山河斧	Mountain and River Axe
灵器	Spirit Tool
魔生剑	Demon Birth Sword
死灵之花	Flower of Dead Souls
血槐树	Blood Locust Tree
鲜于彩	Xianyu Cai
柳章族	Willow Octopus Race
真龙血石	True Dragon's Bloodstone
赫连天云	Helian Tianyun
锁天大阵	Sky Sealing Great Formation
凌见雪	Ling Jianxue
聚元境	Element Gathering Tier
祖龙	Ancestor Dragon
地龙宗	Earth Dragon Sect
妖蛇王	Demon Serpent King
天凤神女	Heavenly Phoenix Divine Maiden
龙威	dragon's might
亚龙	alternative dragon
天剑宗	Heaven's Sword Sect
铸器师	Weaponsmiths
沉香谷	Sunken Fragrance Valley
生命禁区	Life-Restricted Area
血蠕虫	Bloodworm
鬼龙窟	Ghost Dragon Cave
八荒阿鼻剑法	Desolate Hell Sword Technique
山河斧	Mountain and River Axe
灵器	Spirit Tool
魔生剑	Demon Birth Sword
死灵之花	Flower of Dead Souls
血槐树	Blood Locust Tree
鲜于彩	Xianyu Cai
柳章族	Willow Octopus Race
真龙血石	True Dragon's Bloodstone
赫连天云	Helian Tianyun
锁天大阵	Sky Sealing Great Formation
凌见雪	Ling Jianxue
聚元境	Element Gathering Tier
祖龙	Ancestor Dragon
地龙宗	Earth Dragon Sect
妖蛇王	Demon Serpent King
修罗魔帝	Asura Demon Emperor
混沌源石	Chaos Source Rock
马多宝	Ma Duo Bao
寒锋会	Cold Spear Association
寒城	Cold City
宙光城	Eternal Light City
封宜修	Feng Yixiu
陈瑞靖	Chen Ruijing
云永望	Yun Yongwang
康修元	Kang Xiuyuan
江跃枫	Jiang Yuefeng
青凤神后	Blue Phoenix Divine Empress
义山王	Justice Mountain King
火焰王	Flame King
金浑王	Pure Golden King
天星王	Heavenly Astral King
大水王	Great Water King
通阳王	Clear Solar King
昌平王	Opulent Peace King
九幽王	Ninth Underworld King
卓奇方	Zhuo Qifang
星辰境	Heavenly Body Tier
恒河境	Eternal River Tier
山河境	Mountain River Tier
天道之眼	Eye of Heavenly Dao
萧妙颜	Xiao Miaoyan
关阳	Guan Yang
极阳术	Extrreme Yang Technique
混沌	Primal Chaos
三生尸棺	Three Lives Corpse Casket
护教法王	Protector Technique King
伍高原	Wu Gaoyuan
风破云	Feng Po Yun
灵婴境	Spiritual Infant Tier
敖剑	Ao Jian
九彩大悲枪	Nine Colours Great Grief Spea
枪扫佛径	Spear Sweeps Seeming Tracks
丁平	Ding Ping
赤日宗	Crimson Sun Sect
丁飞文	Ding Feiwen
柳镇时	Liu Zhenshi
赤阳宗	Crimson Sun Sect
马军山	Horse Army Mountain
神界	Immortal Realm
灵气	Spiritual Qi
真凰	True Phoenix
帝朝	Imperial Empire
皇朝	Majestic Empire
王朝	Royal Empire
向承允	Xiang Chengyun
东虚王朝	Eastern Void Royal Empire
安水王朝	Content Water Royal Empire
严永逸	Yan Yongyi
雷中王朝	Thunder Central Royal Empire
乱星皇朝	Chaotic Stars Majestic Empire
宙天	Eternity Sky
碧落	Jade Drop
赤天学院	Scarlet Heaven Academy
合宁星	Joint Peace Planet
点星城	Point Star City
创世境	Genesis Tier
厉程	Li Cheng
厉相	Minister Li
厉薇薇	Li Weiwei
季云儿	Ji Yun'er
罗霸	Luo Ba
白星塔	White Star Tower
罗烈	Luo Lie
马兴	Ma Xing
林由	Lin You
斗兽场	Battle Arena
程浩飞	Cheng Haofei
王者之气	King's Qi
司马	Minister of War
张德满	Zhang Deman
真元石	True Origin Stone
黑玉汤池	Black Jade Pool
灵池	Spiritual Pool
补神丹	Replenishing Spirit Pill
星阳丹	Star Yang Pill
严东奇	Yan Dongqi
付会	Fu Hui
水雁玉	Shui Yanyu
周梦槐	Zhou Menghuai
赵伦	Zhao Lun
灵肉	Spiritual Meat
神兽	Divine Beast
北分院	Northern Institution
师妹	Junior Sister
积分	academic credits
三火引	Three Fire Guide
丹劫	pill tribulation
炽燃水晶	Stored Light Crystal
舍不了孩子套不了狼	you have to lose some to gain some
古灵玉	Gu Lingyu
十万	hundred thousand
百万	million
丹分院	Alchemy Institution
天翼神剑	Heavenly Winged Divine Sword
执法长老	Law Enforcement Elder
和林药铺	United Forests Pharmacy
罗觊风	Luo Kaifeng
魏千树	Wei Qianshu
执法会	Law Enforcement Committee
罗洪道	Luo Hongdao
罗凯风	Luo Kaifeng
国库	National Treasury
血泣石	Bloodtear Stone
左相	Left Minister
神果	Divine Fruit
左萧	Zuo Xiao
王宛	Wang Wan
张青	Zhang Qing
战帖	battle notice
七杀镇魂术	Seven Kill Subduing Soul Technique
千锋山	Thousand Spear Mountain
叶承运	Ye Chengyun
莫俊人	Mo Junren
帝江	Imperial River
琉焰青纹虎	Precious Flame Blue-Patterned Tiger
冰原虎	Ice Genesis Tiger
武道精魄	Soul Essence of Martial Arts
宫主	Imperial Empress
天圣宫	Heavenly Saint Palace
暗夜堂	Dark Night Hall
水子歌	Shui Zige
蒙毅	Meng Yi
铜牌	copper-plated
胡菲芸	Hu Feiyun
黑焰国	Black Flame Nation
东分院	Eastern Institution
九郡王	Ninth King
杨梓	Yang Ci
西分院	Western Institution
吞天功	Heaven Swallowing Technique
刘恒	Liu Heng
白元思	Bai Yuansi
天海秘境	Heavenly Sea Mystery Realm
山河石	Mountain River Stone
重元石	Heavy Origin Stone
火焰石	Flame Stone
皇家练武场	Imperial Training Fiel
孔雀明王	Peacock Flame King
大龟王	Big Turtle King
玄武	Black Tortoise
月蓉儿	Yue Rong'er
钟海	Zhong Hai
孔雀百翎	Peacock's Numerous Plumes
破灭乾坤	Shatters the Cosmos
怒海拳	Furious Sea of Fists
神之领域	God's Territory
宫女	palace maid
空舰	warship
丁立安	Ding Li'an
小极位	low extreme
中极位	medium extreme
大极位	high extreme
玉阳丹	Jade Sun Pill
唐风	Tang Feng
仙金	Divine Metal
神铁	Godly metal
银角狂犀	Silver Horned Mad Rhinoceros
妖兽	Demonic Beast
赤湖	Crimson Lake
精神秘术	spiritual secret technique
飞行神器	Flight God Tool
空间神器	Spatial God Tool
精华	essence
抽取	extract
炼化	refined
武者	cultivator
至宝	precious treasures
甚至	in fact
大大咧咧	boldly
大大咧咧	casually
鲁莽	reckless
鲁莽	rash
体魄	physique
神火	divine flame
丹田	Dantian
中期	middle stage
力不从心	strained
无奈	reluctant
无奈	exasperation
无奈	helpless
无奈	begrudging
运转	channel
运转	practice
宙天国	Eternity Sky Majestic Empire
巅峰	peak
三星天才	three-star genius
超重力	extreme weight
游浩	You Hao
秘术	secret technique
老怪物	old monsters
少主	Young Master
后期	late stage
呸	ptui
不自量力	biting off more than you can chew
第	Chapter
大人物	powerful figure
大人物	mighty figure
妖孽	freakish
小子	brat
小友	young friend
武道界	martial arts world
喷了出来	splutter
小小境界	sub-minor level
少爷	Young Master
领悟	comprehension
领悟	enlightenment
小境界	minor tier
小境界	minor level
纹路	veined pattern
神纹	divine pattern
乾坤大挪移	Great Shift of Yin and Yang
玄元三式	Three Styles of Black Origin
天剑宫	Heaven's Sword Palace
一星天才	one-star genius
前期	early stage
巅峰	peak stage	when talking about ranks/tiers
巅峰	pinnacle
五星天才	five-star genius
四星天才	four-star genius
力量	power
实力	strength
实力	abilities
施浩	Shi Hao
化天碗	Heaven Transformation Bowl
不由	involuntarily
不由	couldn't help but
品阶	grade
小世界	small world
施展	cast
秘法	secret technique
武技	martial arts techniques
神境	Immortal level
终极一箭	Ultimate Arrow
识海	mind
右相	Right Minister
七大将	the Seven Generals
灵液	spiritual liquid
听芹	Ting Qin
韵容	Yun Rong
恶兽	evil beast
九王	Ninth King
神魂	divine sense
超级强者	super elite
神躯	Godly physique
战意	fighting spirit
底牌	trump card
狼妖	Demon Wolf
奥义	profound meaning
生命力	vitality
神箭	Godly Arrow
精神冲击	spiritual attack
气势	aura
杀意	killing intent
丹药	alchemical pill
功法	cultivation technique
神级	Immortal level
半人	Half Human
强者	elite
大能	great elite
叶文山	Ye Wenshan
汤华	Tang Hua
破虚部	Shattering Void Tier Division
小极部	Low Extreme Division
手下	subordinate
范勇	Fan Yong
火焰窟	Flame Cave
李思蝉	Li Sichan
刘雨桐	Liu Yutong
师兄	Senior Brother
师姐	Senior Sister
师弟	Junior Brother
初期	early stage
神骨	Godly bones
二星天才	two-star genius
终级一箭	Ultimate Arrow
家族	clan
呸	pei
徐然	Xu Ran
重力	gravity
超级天才	super genius
独眼魔猿	Single Eye Demonic Ape
熔岩兽	Lava Beast
兽王	Beast King
赤罗锁地网	Crimson Ground Locking Net
罗家	Luo Clan
特殊属性	special attribute
罗浩民	Luo Haomin
罗剑	Luo Jian
越级战斗能力	tier surpassing battle prowess
重力神纹	divine patterns of gravity
玄妙三千	Mysterious Three Thousand
规则	Regulations
身法	movement technique
大圆满	consummate level
空间灵器	Spatial Spirit Tool
真一魔主	Demon Master Zhen Yi
冥界	Netherworld
魔主	Demon Master
体术	Body Art
岩兽王	Lava Beast King
风车山	Windmill Mountain
大将军	Great General
安兰王	King An Lan
戚峰	Qi Feng
七星诀	Seven Star Secrets
沙景	Sha Jing
赵剑白	Zhao Jianbai
北漠赤阳功	Northern Desert Crimson Sun Technique
意境	Intent Realm
天地大道	Dao of Heaven and Earth
毕竟	after all
宝瓶	treasure bottle
宝镜	treasure mirror
武道意志	martial intent
加成	boost
绝地棍法	Supreme Staff Technique
六合八荒功	Universal Eight Desolation Technique
徐老头	Old Man Xu
太一玉髓心	Highest Jade Essence Heart
武官	military officer
玄雷地诃诀	Black Thunder Ground River Secrets
战佛	War Buddha
精血	blood essence
破月诀	Moon Shattering Secrets
罗青	Luo Qing
铁血场	Iron Blood Stadium
万法归一	10,000 Techniques Return to One
日月境	Sun Moon Tier
鲲鹏宫	Roc Palace
破虚二十星	20 Stars of the Shattering Void Tier
九死转生神丹	Nine Deaths Reincarnation Divine Pill
柳莹	Liu Ying
沙原	Sha Yuan
死卫	death guard
四豹	Four Panthers
柳蕙兰	Liu Huilan
荆无血	Jing Wuxue
上官元基	Shangguan Yuanji
赵大将军	Great General Zhao
白云星铁	White Cloud Star Metal
云凤真血	Cloud Phoenix True Blood
上古神兽	Ancient Divine Beast
真凤	True Phoenix
血脉	bloodline
嚣张	arrogant
挑衅	provoke
哼	humph
神光	divine light
古迹	ancient site
火焰神纹	divine patterns of flame
天份	talent
秒杀	insta-kill
小心眼	petty
生死战	mortal duel
心境	mental state
高手	elite
天地	heaven and earth
一柱香	thirty minutes
四小姐	Fourth Young Miss
传承	inheritance
杀气	killing intent
大白猫	big white cat
付院长	Head Fu
兽宠	beast pet
丹院	Alchemy Institution
抽魂	pluck one's soul
分院长	Head of Institution
尤物	seductive beauty
腐水三千	Corrosive Water Three Thousand
残金战佛拳	Residual Gold War Buddha Fist
神链	divine chains
绝学	ultimate technique
天赋	natural talent
神灵	Immortal
轮回茶	Reincarnation Tea
女皇	empress
七品武将	seventh-rank military officer
真元石卡	True Origin Stone Card
帝国	Majestic Empire
啧	tsk
海贼	pirates
矜持	reservedness
势力	force
仇恨光环	halo of trouble
穿云梭	Cloud Piercing Shuttle
王者	king tier
圣意	imperial decree
轮回树	Reincarnation Tree
傲娇	tsundere
丹道帝王	Alchemy Emperor
黑五帮	Black Five Gang
大乘帮	Great Chariot Gang
丹方	pill recipe
修炼	cultivate
霸斧码头	Tyrant Axe Harbour
杨通天	Yang Tongtian
姜吉	Jiang Ji
卢奇伟	Hu Qiwei
赵家	Zhao Clan
招揽	recruit
神丹	Divine Pill
玉符	jade seal
仙域	Celestial Realm
仙王	Celestial King
斩尘境	Severing Mundane Tier
星辰海	Star Sea
傀儡	puppet
轩辕紫光	Xuanyuan Zi Guang
恒天大陆	Lower Realm
姜安云	Jiang Anyun
少帮主	Young Gang Leader
妖	bewitching
杨家	Yang Clan
客栈	inn
杨铁成	Yang Tiecheng
气天丹	Heavenly Qi Pill
天玑丹	Heavenly Pearl Pill
黑迷雾	Black Fog
药材	medicinal ingredients
灵药	Spiritual Herb
炉	cauldron
罗玉	Luo Yu
罗悟	Luo Wu
罗森云	Luo Senyun
极境	pinnacle level
麻衣	coarse clothes
沙家	Sha Clan
金致辉	Jin Zhihui
周高阳	Zhou Gaoyang
伏天	Fu Tian
殷元香	Yin Yuanxiang
杨兄	Brother Yang
丹道	alchemy
几万	tens of thousands
丈	three meters
铁青	livid
分魂	Dividing Soul Tier
仙府	Immortal Palace Tier
升源	Ascending Origin Tier
仙王	Celestial King Tier
五分魂	Dividing Five Souls
六分魂	Dividing Six Souls
七分魂	Dividing Seven Souls
九分魂	Dividing Nine Souls
八分魂	Dividing Eight Souls
小成	Small Accomplishment	for Ascending Origin Tier
大成	Great Accomplishment	for Ascending Origin Tier
九重	Nine Heavens	for Celestial King Tier
天尊	Heavenly Venerable Tier
生命指数	Vitality Index
纪元	epoch
十二万亿	12 trillion
元年	era
万影化身诀	Many Shadows Embodiment Technique
魔爆蛇	Demonic Snake
魔爆蛇王	Demonic Snake King
秘	Small Realm	when referring to Immortal Palace Tier
异域	Foreign Realm
叶	Leaf	Minor levels for tiers in Foreign Realm
蛇王	Demonic Snake King
妖蛇	Demonic Snakes
秘宝	rare treasure
铸剑山庄	Swordforge Manor
地心岛	Earth's Core Island
傀儡师	puppeteer
董玉龙	Tong Yulong
郭修文	Guo Xiuwen
崔德	Cui De
步正云	Bu Zhengyun
阵法师	Formation Master
占卜师	diviner
星象师	astrologer
地心洞	Earth's Core Cave
宁泰	Ning Tai
杨大人	Captain Yang	for sailor at Star Sea
神魂	spirit
乱星	Luan Xing
乱星女皇	Empress Luan Xing
裴济	Pei Ji
神雾	Divine Mist
傀儡虎	puppet tiger
丹师	alchemist
经脉	meridian
魔气	Demonic Qi
徒弟	disciple
圣	Saint	when referring to cultivators at the Genesis Tier
小帝	Little Asura	When referring to Asura Demon Emperor. (i think calling him Little Emperor sounds weird)
准	pseudo	when talking about cultivation levels
后阳	Hou Yang
居乐云	Ju Yueyun
散修	lone cultivator
灰云章	Grey Cloud Octopus
鬼面蟹	Demon Faced Crab
黑甲虾	Black Armoured Prawn
大乌龟	Giant Turtle
海马	Seahorse
体力	stamina
意志	willpower
遗迹	historical site
太初石	Absolute Beginning Stone
星辰	heavenly body	i.e. star
洞府	abode
金纹鲨	Golden-patterned Shark
魔力	Demonic Power
魔力源泉	Demonic Power Source
神药	Godly medicine
四字剑诀	Four Form Sword Technique
宗师	grandmaster
快字诀	Fast Technique
慢字诀	Slow Technique
乱字诀	Chaotic Technique
平字诀	Calm Technique
无敌剑圣	Invincible Sword Saint
秘力	mystical power
西城	Xi Cheng
杨轩	Yang Xuan
红颜	lover
杨珞丹	Yang Luodan
碧霄丹	Jade Heaven Pill
寿元	lifespan
碧霄丹	Jade Heaven Pill
身份令牌	identity token
大境界	major tier
吴兹仁	Wu Ziren
太玄青冥丹	Mysterious Azure Pill
鸠吾戚	Jiu Wuqi
水家	Shui Clan
福	curtsy
赵世子	Heir Zhao
伦哥	Brother Zhao	(i think Brother Lun is unclear, and i couldnt be bothered footnoting)
武道界	cultivation world
两界战场	Two Realm Battlefield
安老	Elder An
严小萱	Yan Xiaoxuan
中极部	Medium Extreme Division
金狮国	Golden Lion Nation
东雨国	Eastern Rain Nation
官爵	official rank
药铺	pharmacy
副院长	Deputy Head
四大分院	four major institutions
至强者	supreme elite
学院军	academy troops
柳青	Liu Qing
森然	baleful
森然	wicked
森然	sinister
煞人	Fiend
坑	screw sb. over
蔫坏	devious
紫眼熊	Purple Eyed Bear
霸天熊	Overlord Heaven Bear
九焰天王	Nine Flames Heavenly King
九煞剑	Nine Demons Sword
战仆	battle servants
常家	Chang Clan
韧性	toughness
煞气	murderous aura
祭坛	sacrificial altar
宙天皇	Eternity Sky Emperor
灵魂	soul
怒江	furious river
飞梭	shuttle
宝甲	treasured armor
兵部	Minsitry of War
孔成和	Kong Chenghe
古天初	Gu Tianchu
南门扬	Nanmen Yang
姐姐大人	Big Sister
碧落皇	Jade Drop Emperor
瞿秋雪	Qu Qiuxue
武将	military officer
残夜	Can Ye
雨皇	Rain Emperor
慕容青	Murong Qing
凌少	Young Master Ling
精神	spirit
师伯	uncle
石灵	Stone Spirit
五行生灵	spirits of the five elements
丁家	Ding Clan
开天	opening the sky
七祖爷	seventh great-grandfather
五宗	Five Sects
剑意	sword intent
张陌	Zhang Mo
小剑帝	Small Sword Emperor
剑光	sword light
剑道	Sword Dao
破虚	Shattering Void Tier
云凤宗	Cloud Phoenix Sect
府第	manor
剑王	Sword King
时间源液	Time Source Fluid
真龙	True Dragon
一界丹	Realm Pill
司徒剑	Situ Jian
祖地	ancestral grounds
断天刀	Severing Heaven Saber
悟道	comprehend
岳开宇	Yue Kaiyu
钱无用	Qian Wuyong
胡风月	Hu Fengyue
金兄	Brother Jin
噬金铁	Devouring Metal
仙魔剑	Divine Demon Sword
质变	qualitative change
大星	great star
凛天宗	Majestic Heaven Sect
沈中城	Shen Zhong Chen
闻一剑	Wen Yi Jian
广元	Guang Yuan
朱无久	Zhu Wu Jiu
元承和	Yuan Cheng He
丹师协会	Alchemist Society
林香芹	Lin Xiang Qin
闻人芊芊	Wenren Qian Qian
四弟	Fourth Brother
岳震山	Yue Zhen Shan
凛天宗	Majestic Heaven Sect
飞云星	Flying Cloud Planet
光龙星	Light Dragon Planet
三元上人	Venerable Trinity
两界通道	passageway of the two realms
祖血	ancestral bloodline
大圆满部	Consummate Level Division
敕封	appoint
杨霜	Yang Shuang
唐九	Tang Jiu
星系	galaxy
星域	universe
星船	starship
商队	merchants
商队	traveling merchants
九王	Nine Kings
十星天才	10-star genius
极致	pinnacle
六星天才	six-star genius
九星天才	nine-star genius
阵法	formations
星海	galaxy
生命精气	life essence
大坟	large tomb
星空	galaxy
夏无缺	Xia Wuque
霸夏皇朝	Domineering Summer
大长星	Great Growth Planet
公子	Young Master
无缺公子	Young Master Wuque
石像大军	Stone Statue Army
追随者	followers
石碑	stone tablet
石像阵	stone statue formation
枪男	spear-wielding man
难道	could it be
难道	don't tell me
克星	nemesis
石像	stone statue
天才	prodigy
邵思思	Shao Sisi
南丰星	Southern Plentiful Planet
千霜皇朝	Thousand Frost Majestic Empire
苏经	Su Jing
太流宗	Large Stream Sect
杜安	Du An
规则之力	power of Regulation
恢复力	recovery ability
耍人	messing with
金刚符	Vajra Seal
狮子符	Lion Seal
疾云符	Quick Cloud Seal
赤火针	Crimson Fire Needle
三彩风火莲	Tricolor Wind and Fire Lotus
空间戒指	spatial ring
虚弥袋	Virtual Pouches
陛下	Your Majesty
灭圣弩	Saint Destroying Crossbow
龙香丹	Dragon Fragrance Pill
圣器	Saint Tool
九死天功	Nine Deaths Heaven Art
杀手	assassin
神符	divine seal
太风	Tai Feng
长老	elder
龙袍	imperial robe
三彩风火莲	Tricolor Wind and Fire Lotus
龙香丹	Dragon Fragrance Pill
海之森林	Forest of the Sea
元气	vitality
后怕	lingering fear
灵芝	ganoderma
人参	ginseng
凌兄	Brother Ling
全立轩	Quan Lixuan
罗景仁	Luo Jingren
关荣	Guan Rong
师兄弟	Sect Brothers
师姐	Sect Sisters
器灵	Tool Spirit
食影族	Shadow-eating Tribe
两界通道	Two Realm Passageway
全力轩	Quan Lixuan
紫纹山河丹	Purple Pattern Mountain River Pill
无敌至圣	Invincible Paragon Saint
臭流氓	damn pervert
大道之剑	Sword of the Great Dao
嗤然	scoff
紫纹星辰丹	Purple Pattern Heavenly Body Pill
无敌至尊	Invincible Paragon Saint
天元道果	Heavenly Origin Dao Fruit
道果	fruits of cultivation
无相圣人	Notionless Saint
圣源	Saintly Origin
圣威	saintly might
转魂花	Reincarnation Flower
圣王	Saint King
九蛇族	Nine Snake Tribe
傲娇	proud	I'm not sure if the author actually means tsundere for some characters (imo seems a bit off sometimes?)
天材地宝	natural treasures
天道	Heavenly Dao
魔主精元	Demonic Power Source
上古天族	ancient divine tribe
古天族	ancient divine tribe
道基	dao foundation
易容丹	Change Appearance Pill
五行之躯	Five Element Body
天人之厄	Immortal's Calamity
四海皇朝	Four Seas Majestic Empire
天钧皇朝	Great Heaven Majestic Empire
张桐	Zhang Tong
杨浩	Yang Hao
韩林	Han Lin
墨孤	Mo Gu
天风山	Heavenly Wind Mountain
穿云峰	Cloud Piercing Peak
白云峰	White Cloud Peak
小圣	Small Saint
中圣	Medium Saint
大圣	Great Saint
天远酒楼	Heavenly Distant
武道之心	dao heart
大统领	Great Commander
禁卫军	Imperial Guards
星空坐标	galactic coordinates
星图	star chart
无上强者	supreme elite
弟子	disciple
海云长老	Elder Hai Yun
翠嶂鼎	Emerald Cliff Cauldron
仿器	replica
白霜峰	White Frost Peak
范如	Fan Ru
黑水峰	Black Water Peak
毕华	Bi Hua
干诗云	Gan Shiyun
神女炉	Goddess Furnace
符良夜	Fu Liangye
百鸟皇朝	Hundred Bird Majestic Empire
超级势力	super-powerful force
种子级天才	seed-level genius
烈焰焚天	Roaring Flames Incinerate the Heaven
神焰	divine flame
陈晓	Chen Xiao
朝宣	Chao Xuan
蓝鸾	Lan Luan
寒少	Young Master Han
吴哲	Wu Zhe
何滔	He Tao
迷糊	ditzy
章龙	Zhang Long
武文通	Wu Wentong
石安国	Shi Anguo
沈竹儿	Shen Zhu'er
匡佩杉	Kuang Peishan
六王	six kings
极夜寒冰	Extreme Night Frosty Ice
幽杨茶叶	Serene Poplar Tea Leaves
幽杨茶	Serene Poplar Tea
方进	Fang Jin
蓝嘴鸟	blue-beaked bird
死灭冲击波	Perishing Shockwave
三云三花剑	Three Clouds Three Flower Sword
梦魇绝功	Extreme Nightmare Technique
雷霆剑法	Lightning Sword Technique
天子拳法	Son of Heaven Fist Technique
幽扬茶	Serene Poplar Tea
匡佩衫	Kuang Peishan
杨大人	Lord Yang	cultivator from Majestic Heaven Sect
精神烙印	spiritual mark
魏则诚	Wei Zecheng
大绝血虎术	Absolute Great Blood Tiger Technique
韩兄	Brother Han
韩师兄	Senior Brother Han
黄泉秘境	Yellow Spring Mystery Realm
郜门	Gao Faction
盖咏思	Gai Yongsi
郜方	Gao Fang
郜荒	Gao Huang
墨氏商号	Mo Clan Establishment
墨家	Mo Clan
墨家商号	Mo Clan Establishment
韩火	Han Huo
墨氏商号	Mo Clan Business
韩少	Young Master Han
韩掌柜	Manager Han
七绝飞火丹	Seven Ultimate Flying Flame Pill
千鸟峰	Thousand Birds Peak
诸天愁	Zhu Tianchou
千源真液	Thousand Source True Fluid
黄泉	Yellow Spring
氤氲夺魂花	Misty Soul Capturing Flower
死亡谷	Death Valley
玉佩	jade pendant
圣甲虫	Saintly Scarabs
九重神莲	Nine Layer Divine Lotus
孟团长	Leader Meng
孟苇	Meng Wei
神念	divine sense
体修	Body Arts
狂野血灵丹	Berserk Blood Spirit Pill
季正平	Ji Zhengping
蝮毒爆丹	Viper Poison Explosive Pill
纨绔	profligate
红雨神王	Red Rain Divine King Tree
老参	old ginseng
神液	divine fluid
千鹤丹	Thousand Crane Pill
法旨	decree
时明	Shi Ming
贱参	despicable ginseng
宝液	treasure fluid
道誓	dao oath
气态人	aura-formed person
花门	Hua Faction	郜门
姬云芝	Ji Yunzhi
周通	Zhou Tong
千万	ten million
花阳文	Hua Yangwen
花永宁	Hua Yongning
胡门	Hu Faction
胡向迪	Hu Xiangdi
雷玲珑	Lei Linglong
沉阴老魔	Sinking Shade Old Demon
蓝云	Lan Yun
地心	land's heart
蓝肤强者	blue-skinned elite
摘星步	Star Plucking Step
于四	Yu Si
白玉殿	White Jade Palace
沈括	Shen Kuo
马概	Ma Gai
杨师叔	Uncle Yang	when referring to Yang Hao
师父	master
妞	Niu
天人之衰	Celestial Decline
感悟	appreciation
青衣老妪	old woman in cyan
云顶星	Cloud Apex Planet
九蛇池	Nine Snake Pond
灵雨洗骨丹	Spiritual Rain Bone Developing Pill
大赤阳帝朝	Great Crimson Sun Imperial Empire
赤焰皇	Crimson Flames Emperor
雷爆丹	Explosive Thunder Pill
雷霆果	Lightning Fruit
赤云藻	Crimson Cloud Aquatic Grass
创世之力	power of construction	for Genesis Tier Saints (depends on context)
灭世之力	power of destruction	for Demon Masters
武道层次	overall level of cultivation
河外	Eternal River
星域	galaxy	(dependent on context)
长光星域	Long Light Galaxy
寒临阁	Han Lin Pavilion
梁金波	Liang Jinbo
康兄	Brother Kang
云兄	Brother Yun
四方丹	Four Directions Pill
宝林阁	Treasure Forest Pavilion
胡丹师	Alchemist Hu
凌大师	Grandmaster Ling
大营城	Big Trade City
何大师	Grandmaster He
何景云	He Jingyun
老头	old geezer
李丹师	Alchemist Li
栖霞山	Red Clouds Perch Mountains
五阶丹师	Level Five alchemist
大师	Grandmaster
四云四起丹	Four Clouds Four Rising Pill
老头	old man
大长老	senior elder
天威	heaven's might
灵海境	Spiritual Ocean Tier
丹道等级	alchemy level
林雨绮	Lin Yuqi
主上	lord
主上	milady
韩心妍	Han Xinyan
天凤女	Heavenly Phoenix Maiden
马漳	Ma Zhang
红雨神王果	Red Rain Divine King Fruit
韩大师	Grandmaster Han
九皇金钟丹	Nine Emperor Golden Bell Pill
凌家未亡人	Ling Family's Widow
永望	Yongwang
水元谷	First Water Valley
左前尉	Left Vanguard
谢前	Xie Qian
谢东来	Xie Donglai
水元谷	Water Element Valley
青萝	Qing Luo
界灵石	Realm Spirit Stone
紫月军	Purple Moon Army
古丹方	ancient pill recipe
功勋	merit points
十二天秘境	Twelve Heaven Mystery Realm
天河王	Heavenly River King
青焰雕	Azure Flame Vulture
几千万	tens of millions
狼牙城	Wolf Fang City
蓝云帝朝	Blue Cloud Imperial Empire
紫月神女	Purple Moon Divine Maiden
长风军	Wind Riders Army
长风天王	Wind Rider Divine King
罗汉军	Holy Army
广行僧王	Wide Travel Monk King
剑影	sword projections
小寒子	Little Han
参爷	Grandpa Ginseng
五行之灵	spirit of the five elements
石头人	rock golem
天凤姐	Sister Heavenly Phoenix
朱丽云	Zhu Liyun
云姐	Big Sister Yun
传送阵	Transfer Formation
敖子云	Ao Ziyun
八阶丹师	level eight alchemist
黑龙族	Black Dragon Race
两界天骄会	Two Realm Prodigy Gathering
谢家	Xie Clan
仙焰	immortal flame
浴火重生	Rising From The Ashes
仙凰	Immortal Phoenix
仙龙	Immortal Dragon
暗灭黑龙枪	Dark Destruction Black Dragon Spear
仙界	Celestial Realm
丹毒	alchemic poison
千幻刀	Thousand Hallucination Saber
炎军	Yan Jun
鲲鹏	Roc
炎师弟	Junior Brother Yan
烈焰宗	Blazing Inferno Sect
老张客栈	Old Zhang's Inn
七师兄	Seventh Senior Brother
茅祖师	Founder Mao
赤荒极	Chi Huangji
钱师叔	Uncle Qian
仙兽	Immortal Beast
不灭生命之火	Indestructible Flame of Life
混沌原兽	Primal Chaos Origin Beast
万化龟	Thousand Transformations Tortois
金刚蚁	Diamond Ant
钱森	Qian Sen
高层	higher-up
森然	menacing
金源拍卖行	Gold Origin Auction House
几十万	hundreds of thousands
山河林	Mountain River Forest
日月谷	Sun Moon Valley
谢大将军	Great General Xie
金宣	Jin Xuan
碧春阁	Jade Spring Pavilion
金明	Jin Ming
金家	Jin Clan
世子	heir
金宣	Jin Xuan
炼器	tool refinement
谢世子	Heir Xie
无面	Faceless
无面兄	Brother Faceless
空间袋	Spatial Sack
柳十	Liu Shi
青雷宗	Blue Thunder Sect
十二部大将	twelve military officers
柳祖师	Ancestor Liu
中年男子	middle-aged man
张横	Zhang Heng
青鸾	Azure Phoenix
黑金魔鹰爪	Black Gold Demonic Eagle Claw
祖器	ancestral weapon
韩风	Han Feng
上官巧	Shangguan Qiao
惜花宫主	Palace Leader Xi Hua
小主	Little Master
乱魔宫	Chaotic Demon Palace
铁无涯	Tie Wuya
追星步	Star Plucking Step	author made a typo when introducing the technique, so it's actually plucking
月影	Yue Ying
北皇	North Emperor
石皇	Stone Emperor
杨林	Yang Lin
云女	Cloud Maiden
拓拔东	Tuoba Dong
谈葛	Dan Ge
拓跋东	Tuoba Dong
小青	Little Qing
九河上人	Nine River Venerate
千峰帝朝	Thousand Peak Imperial Empire
容涛	Rong Tao
左全	Zuo Quan
圣料	Saintly Material
峡谷	canyon
凤血真金	Phoenix Blood True Gold
梦回木	Returning Dream Wood
生命之火	flame of life
先天石灵	Natural-born Stone Spirit
丰海星域	Plentiful Sea Galaxy
青海圣人	Plentiful Sea Saint
普道星域	Universal Dao Galaxy
云石圣人	Cloud Stone Saint
王中王	king among kings
无颜族	Faceless Tribe
顶级王者	supreme king tier
天雷	divine lightning
仙气	Celestial Qi
破金三拳	Gold Crushing Three Punches
本源神焰	essence divine flames
手诀	hand seals
木灵	Wood Spirit
仙兵	Celestial Tool
柔妖女	Bewitching Maiden Rou
打量	survey
银河	silver river	for Eternal River Tier
战车	chariot
紫金牛	purple-gold bull
邪物	evil beast
地狱烈火阵	Fiery Hell Formation
七霜星域	Seven Frost Galaxy
丁子真	Ding Zizhen
练武场	training ground
丁耀龙	Ding Yaolong
千秋岁月	Tide of the Ages
耀龙	Yaolong
斩尘	Severing Mundane
岁月千秋	Tide of the Ages
老祖	ancestor
丁伶	Ding Ling
仙术	celestial technique
仙人	Celestial	because we used "immortal" for 神灵
星沙武院	Star Sand Martial Arts Academy
四方星域	Myriad Directions Galaxy
星沙圣人	Star Sand Saint
赤焰帝	Crimson Flame Emperor
蓝云帝	Blue Cloud Emperor
古许	Gu Xu
劫云	tribulation cloud
杀机	killing intent
血侍	Blood Servants
本源	life force
柏崇	Bai Chong
付东流	Fu Dongliu
五行之体	Five Element Body
寒风掌	Cold Wind Palm
天剑城	Heaven's Sword City
祖师	Founder
凌岳锋	Ling Yuefeng
江巧灵	Jiang Qiaoling
恶鬼	evil spirit
陈娣	Chen Di
枫郎	Yuefeng
陈金	Chen Jin
凌空诚	Ling Kongcheng
跃枫	Yuefeng
太祖	Great Ancestor
柳东明	Liu Dongming
程元	Cheng Yuan
师娘	missus
纳兰突	Nalan Tu
空灵龙马	Ethereal Dragon Horse
赵苦	Zhao Ku
时光源液	Time Source Fluid
林宪	Lin Xian
厉若彤	Li Ruotong
聚风城	Gathering Wind City
司马林	Sima Lin
司马家	Sima Clan
苦少	Young Master Ku
十二姬	12 beauties
赵祖翼	Zhao Zuyi
银龙战甲	Silver Dragon Armor
地龙	Earth Dragon
竞技场	tournament ground
九妖	Jiuyao
司徒林	Situ Lin
十亿	billion
司徒见远	Situ Jianyuan
仙器	Celestial Tool
安远	Anyuan Branch
圣药	Saint Pill
林家	Lin Clan
雨姨	Aunty Yu
横云支脉	Hengyun Branch
青雨城	Azure Rain City
北沙	Beisha
林峰	Lin Feng
林雪风	Lin Xuefeng
林建业	Lin Jianye
辜家	Gu Clan
辜少云	Gu Shaoyun
药王窟	Medicine King's Cave
林辛	Lin Xin
林洋	Lin Yang
林拔刀	Lin Badao
林疏影	Lin Shuying
启灵术	Spirit Awakening Technique
张丰	Zhang Feng
入虚丹	Entering Void Pill
冥阴丹	Dark Shade Pill
浑天丹	Turbid Sky Pill
北沙支脉	Beisha Branch
林子宏	Lin Zihong
紫玉九道树	Purple Jade Nine Dao Tree
鬼王窟	Medicine King's Cave	typo by author
韩家	Han Clan
施家	Shi Clan
黄家	Huang Clan
神树	Divine Tree
仙剑	Divine Sword
韩东	Han Dong
泰阳宫	Grand Sun Palace
古道青莲	Ancient Dao Green Lotus
通天玄元丹	Exceptional Talent Black Origin Pill
禅道茶	Zen Tea
洗尘殿	Xichen Palace Hall
泰阳宫	Taiyang Palace
剑痴	sword maniac
绝世大药	supremely valuable medicine
黄鹏	Huang Peng
飞火丹	Flying Fire Pill
爆裂果	Explosion Fruit
摩迦罗	Makara Flower
韩涛	Han Tao
圣王大药	Saint King Great Herb
摩迦罗之花	Flower of Makara
施宾	Shi Bin
古道一	Gu Daoyi
王传洗	Wang Chuanxi
雷动	Lei Dong
天字灭杀令	Heaven Execution Order
九劫剑	Nine Demons Sword
鲁有精	Lu Youjing
大药	Great Herb
狗爷	Grandpa Dog
仙胎	Divine Fetus
鲁成风	Lu Chengfeng
白玉天煞掌	White Jade Murderous Heaven Palm
诅咒王	King of Curses
九幽冰棺	Nine Hells Ice Coffin
丁芝芝	Ding Zhizhi
法相天地	Dao Manifestation
嗡	Weng
星沙大圣	Star Sand Saint
木图星	Wood Figure Planet
柳世原	Liu Shiyuan
柳君天	Liu Juntian
紫风山	Purple Wind Mountain
百老世家	Bailao Clan
石坡门	Stone Hill Faction
燃灯圣人	Dīpankara Saint
闻东	Wen Dong
原少	Young Master Yuan
二阶王者	rank two king tier
一阶王者	rank one king tier
三阶王者	rank three king tier
上官横	Shangguan Heng
东明星域	Eastern Light Galaxy
超大星域	super-large galaxy
大星域	large galaxy
小星域	small galaxy
仙子	celestial maiden
朱悦	Zhu Yue
超级王者	supreme king tier
天凤	Heavenly Phoenix	i.e. Heavenly Phoenix Divine Maiden
五阶王者	rank five king tier
拳魔	Fists Demon
王者杀手	King Tier Assassin
返祖	awaken
沉渊谷	Sunken Abyss Valley
二哥	Second Brother
紫晨风	Zi Chenfeng
龙香月	Long Xiangyue
天下第二	Second in the World
龙香月	Long Xiangyue
浮石	floating rock
聂天成	Nie Tiancheng
聂兄	Brother Nie
飞雨圣人	Flying Rain Saint
单经义	Shan Jingyi
单兄	Brother Shan
六山圣人	Six Mountains Saint
圣果	Saint Fruit
准圣器	Pseudo-Saint Tool
六元山	Six Elements Mountains
紫辰风	Zi Chenfeng
程小凡	Cheng Xiaofan
血神指	God of Blood Finger
天意刀	Heaven's Will Saber
龙族	Dragon Tribe
洪麻	Hong Ma
朝天棍	Skyward Staff
飞花剑	Flying Flower Sword
仙级	Celestial level
老祖	grand elder	depending on context (used for Severing Mundane Tier)
胡宇	Hu Yu
胡家	Hu Clan
九天火	Nine Heavens Flame
苍月城	Dark Moon City
本源之火	origin flame
九大祖火	Nine Great Ancestral Flames
祖火	ancestral flame
本命之火	source flame
太阳石	Sun Stone
真子	True Son
真女	True Daughter
四斩	fourth severance
一斩	first severance
二斩	second severance
三斩	third severance
一斩老祖	first severance grand elder
四斩老祖	fourth severance grand elders
大衍功	Great Evolution Technique
极夜之暗	Darkness of the Paramount Night
苍雨洗尘剑	Sword of Mundane Washing Rain
悲冥元龙破	Dark Grief Origin Dragon Destruction
岁月如歌	Song of the Ages
仙法	celestial technique
道光	Light of Dao
百鬼遮天	A Hundred Ghosts Cloud Heavens
九风腿	Nine Winds Kick
太阳体	Sun Physique
光耀天下	Dazzle the Heavens
万古最天骄	the greatest prodigy of all eternity
幼火	young flame
铁裤衩	iron underwear
铁内裤	iron underwear
十世神通	Mystical Power of Ten Lives
仙光	celestial light
九青圣人	Nine Azure Saint
体质	physique
安明圣人	Peaceful Radiance Saint
黑河圣人	Black River Saint
明心圣人	Tranquil Heart Saint
苦药	Hardship Alchemy
八重门	Eight Doors
九世归一	Nine Lives Fuse as One
百鬼夜行	Hundred Demons in the Night
云霞圣人	Dawn Cloud Saint
石元龟	Stone Origin Tortoise
乌正甫	Wu Zhengfu
狂雨圣人	Torrential Rain Saint
铁刀圣人	Iron Saber Saint
易高宁	Yi Gaoning
刺头	troublemaker
阵眼	formation eye
切磋	spar
入道	succeed Dao
阵纹	formation patterns
刻	inscribe
小黑	Little Black
大黑狗	large black dog	note: i've used he for the dog, since he was gendered when introduced
先祖文心	Ancestor Wenxin
银发金角	silver-haired and golden-horned senior disciple
任非云	Ren Feiyun
八分院	eighth campus
巨头	big shot
圣谕	Saintly Decree
蔡淼	Cai Miao
奇天	Qi Tian
余素素	Yu Susu
阴阳五行阵	Yinyang Five Element Formation
大衍丹	Great Amplification Pill
贾亮	Jia Liang
古院	Ancient Academy	Academy inside Star Sand Martial Arts Academy
莫里	Mo Li
阵道	formations
别院	courtyard
云少爷	Young Master Yun
杀阵	killing formation
张健	Zhang Jian
小姑	aunty
龙家	Long Tribe
铁骨蛮熊血脉	Iron Bone Barbaric Bear Bloodline
铁骨蛮熊	Iron Bone Barbaric Bear
法相	Dao Manifestation
明心阁	Tranquil Heart Pavilion
广场	plaza
万古青莲阵	Ancient Azure Lotus Formation
圣药	Saintly medicine
苦药圣人	Hardship Alchemy Saint
仙源	Celestial Source
王器	Royal Tool
烂木剑	broken wooden sword
王族	royal clan
魔纹	demonic patterns
八院	eighth campus
卫震	Wei Zhen
云少	Young Master Yun
拂尘	fly-whisk
朱秀儿	Zhu Xiu'er
圣母	Saint Missus
血鸦阵	Blood Crow Formation
严青	Yan Qing
禁地	Forbidden Land
八石禁地	Eight Stones Forbidden Land
胡灿	Hu Can
胡兵	Hu Bing
胡静	Hu Jing
青元玉石	Green Origin Jade
开云王	Open Clouds King
边度	Bian Du
施刚阳	Shi Gangyang
宓学名	Mi Xueming
胡英木	Hu Yingmu
胡洛	Hu Luo
圣境	Saint Tier
胡枫	Hu Feng
八石族	Eight Stones Tribe
仙料	Celestial Material
森罗九绝阵	Limitless Nine Deaths Formation
勾力	Gou Li
绿宝鸡	Green Treasure Chicken
水天术	Water Heaven Art
寒云星	Cold Clouds Planet
极光星域	Aurora Galaxy
黑玉山	Black Jade Mountains
污王	Filth King
偷鸡贼	Chicken Thief
广飞尘	Guang Feichen
红晴鱼果	Red Clear Fish Fruit
渡生功	Life Crossing Art
贝开	Bei Kai
宝瓶印	Treasure Bottle Seal
竺萱	Zhu Xuan
竺仙子	Fairy Zhu
霸剑魔主	Overlord Sword Demon Master
莫离	Mo Li
巫觉	Wu Jue
狂乱	Hysteria
海空星	Sea Space Planet
圣纹	Saintly patterns
仙纹	celestial patterns
太古神液	Primordial Divine Fluid
明王果	Bright King Fruit
清灵炼乳	Clear Spirit Condensed Milk
魔莲印	Demonic Lotus Seal
圣级阵法	Saint-level formation
八石术	Eight Stone Technique
诸八	Zhu Ba
黄魔	Yellow Demon
天帝	Heavenly Emperor
谈歾	Tan Mo
魔器	Demonic Tool
谈家	Tan Clan
六祖	Sixth Elder
谈风	Tan Feng
灌力	power boost
飞龙残影手	Flying Dragon Shadow Hands
海龙山	Ocean Dragon Mountain
仙液	celestial fluid
成家	Cheng Clan
狂乱魔主	Hysteria Demon Master
玄魔	Black Demon
成付	Cheng Fu
御虚仙王	Imperial Void Celestial King
御虚	Imperial Void
大动荡	great turmoil
大动乱	great turmoil
魔兵	Demonic Tool
三祖	Third Elder
地魔	Earth Demon
谈云	Tan Yun
东昌	Dongchang
道心	Dao Heart
天魔	Heaven Demon
谈老鬼	Old Geezer Tan
凌污王	Filth King Ling
老天魔	old Heaven Demon
破天盟	Heaven Crushing Alliance
古界	Ancient Realm
欧阳太山	Ouyang Taishan
灵宝银菱	Spiritual Treasure Silver Chestnut
亿万	millions and millions
九节神竹	Nine Segment Divine Bamboo
神竹	Divine Bamboo
青河谷	Green River Valley
太平宫	Peace Palace
叶承章	Ye Chengzhang
郑景	Zheng Jing
刘敢	Liu Gan
章挺	Zhang Ting
叶全	Ye Quan
刘当	Liu Dang
郑漠	Zheng Mo
欧阳河	Ouyang He
冷筱染	Leng Xiaoran
勾海	Gou Hai
古风	Gu Feng
天云破山手	Heavenly Clouds Piercing Mountain Hand
化雾诀	Mist Technique
虚空花	Void Flower
仙花	Celestial Flower
仙药	Celestial medicine
韩奇	Han Qi
九重甲	Nine Layered Armour
九幽冰雾	Nine Underworlds Ice Mist
九幽冰刺	Nine Underwords Ice Spike
九幽寒水旗	Nine Underwords Frost Water Flag
寒霜千影	Frost of Thousand Shadows
九幽城	Nine Underworlds City
神料	Godly Material
放逐术	Banishing Technique
异空间	separate dimension
胡扬尘	Hu Yangchen
胡东平	Hu Dongping
天残腿	Savage Heaven Kick
青羽圣王	Blue Feather Saint King
白虹禁地	White Rainbow Forbidden Land
赤昂血	High Crimson Blood
紫牝神金	Purple Valley Godly metal
九小姐	Ninth Young Miss
龙语姗	Long Yushan
杨子歌	Yang Zige
景怡	Jing Yi
固阳星域	Strong Sun Galaxy
罗海星	Gathered Seas Planet
开云禁地	Open Clouds Forbidden Land
重八度	Zhong Badu
时光龙族	Time Dragon Tribe
重家	Zhong Clan
圣兵	Saint Tool
九脉仙剑	Nine Meridians Celestial Sword
农括山	Agriculture Enclosed Mountains
明王金身	Immovable Deity Metal Body
夺舍	possess
神性精华	divine essence
分身	doppelgangers
激起	spur
凤王	Phoenix King
重野	Zhong Ye
灭世雷霆	Extermination Lightning
电闪	Lightning Flash
三叉戟	three-pronged halberd
杨铭	Yang Ming
童家	Tong Clan
小骨	Xiao Gu
死人菇	Death Mushroom
圣王药	Saint King medicine
闪击	Lightning Flash
毁灭者	Destroyer
魂力	Spiritual Power
先天通灵果	Natural Psychic Fruit
庞真	Pang Zhen
东仙域	Eastern Celestial Realm
西仙域	Western Celestial Realm
星石	Star Stones
一星城	One Star City
苍月军	Dark Moon Army
黑月教	Black Moon Sect
傅家	Fu Clan
丁啸尘	Ding Xiaochen
一星资质	One Star aptitude
二星资质	Two Star aptitude
冒书玉	Mao Shuyu
冒代	Mao Dai
资质	aptitude
屠康	Tu Kang
屠教官	Instructor Tu
血影狼	Blood Shadow Wolf
佛心茯苓	Buddha Heart Fungus
副统领	Vice Commander
段家	Duan Clan
青龙军	Azure Dragon Army
朱雀军	Vermilion Bird Army
白虎军	White Tiger Army
隆家	Long Clan
丁虎	Ding Hu
擂主	defending champion
碧血食人树	Jade Blood Man-Eating Tree
断魂刀	Spirit Severing Saber
念刃	psychic blade
卫波	Wei Bo
秦恨玉	Qin Henyu
罗欣阳	Luo Xinyang
伍精	Wu Jing
山贼	mountain bandits
教官	military instructor
乱风山	Chaotic Wind Mountains
巴雨城	Bayu City
江无伤	Jiang Wushang
隆高飞	Long Gaofei
张充	Zhang Chong
临尘渊	Mortality Barrier Pool
黑月城	Black Moon City
二星城	Two Star City
三星城	Three Star City
丁寻	Ding Xun
白虎队	White Tiger Team
隆成仁	Long Chengren
段文	Duan Wen
青龙队	Azure Dragon Team
朱雀队	Vermillion Bird Team
段军	Duan Jun
裂光球	Cracking Light Sphere
不死物质	Immortal Substance
四星城	Four Star City
五星城	Five Star City
柳暮雨	Liu Muyu
大凌教	Great Ling Sect
驿站	relay station
双极城	Double Extreme City
元兴平	Yuan Xingping
仙云岛	Celestial Clouds Island
斩尘渊	Severing Mundane Pool
圣子	Holy Son
白阳城	White Sun City
苍焰城	Blue Flames City
单玉静	Dan Yujing
圣女	Holy Daughter
疾雷城	Swift Lightning City
边哲	Bian Zhe
长孙良	Changsun Liang
三头银蛟	Three-Headed Silver Dragon
童林	Tong Lin
白茫	White Haze
八星长老	eight star elder
四星长老	four star elder
升龙击	Ascending Dragon Strike
项文昆	Xiang Wenkun
葬鬼剑	Buried Ghost Sword
童金云	Tong Jinyun
百亿	ten billion
百宏城	Hundred Magnificence City
萧家	Xiao Clan
萧东	Xiao Dong
萧胜	Xiao Sheng
斩尘	Severing Mundane Tier
祖庙	ancestral shrine
冒大人	Lord Mao
丁山	Ding Shan
丁松	Ding Song
韩路	Han Lu
三星势力	three-star force
一星势力	one-star force
灵牌	memorial tablets
万兽奔腾	Stampede of Ten Thousand Beasts
三星家族	three-star clan
丁啸龙	Ding Yaolong
觊觎	covet
逆天	heaven-defying
大道规则	Regulations of the Great Dao
扬月城	Moon Scattering City
少宫主	Young Imperial Empress
龙鹰	Dragonhawk
北荒	Desolate North
宋吉	Song Ji
托天城	Heaven Holding City
马颖	Ma Ying
傅晓芸	Fu Xiaoyun
北玄明	Bei Xuanming
最弱斩尘	weakest severance
普通斩尘	normal severance
完美斩尘	flawless severance
太阴教	Lunar Sect
四星势力	four-star force
归元殿	Return to Origin Palace
路霸	highway robbers
斩尘果	Severing Mundane Fruit
斩尘之力	Severing Mundane Power
齐家	Qi Clan
母水	Source Water
死亡窟	Cave of Death
玄阴母水	Xuanyin Source Water
万兽仙王	Multitude Beasts Celestial King
封情殿	Sealed Emotion Palace
封情天尊	Sealed Emotion Heavenly Venerable
丁行	Ding Xing
三界塔	Tower of Three Realms
穹窿山	Sky Mountains
宁浩	Ning Hao
仙丹	Celestial pill
风火九云丹	Winds and Fires Nine Clouds Pill
向严	Xiang Yan
司徒堂	Situ Tang
仙云母参	Celestial Clouds Mother Ginseng
凤血鸡	Phoenix Blood Chicken
库英	Ku Ying
华远城	Splendid Distant City
傅高云	Fu Gaoyun
冰云剑	Icy Clouds Sword
亿	100 million
丁峻	Ding Jun
雷霆霹雳	Thunderbolt
丁霜	Ding Shuang
战兽	Battle Beast
霹雳兽	Thunder Beast
十兽术	Ten Beasts Technique
万鬼铃	Bell of Ten Thousand Ghosts
韩鸿飞	Han Hongfei
药园	Medicinal Garden
七命天云	Seven Lives Divine Clouds
鹿爷	Grandpa Deer
离天城	Heaven Departing City
恨别城	Separation Reluctance City
大王城	Great King City
小王城	Minor King City
离恨城	Separation Resentment City
严老	Elder Yan
司徒小真	Situ Xiaozhen
傅兄	Brother Fu
天龙学宫	Heavenly Dragon Academy
准仙金	Pseudo Divine Metal
黑玉手	Black Jade Hand
傅正同	Fu Zhengtong
走狗	lackey
仙浴池	Celestial Bath Pool
灭仙绝	Ultimate Celestial Elimination
阳魂	yang soul
阴魂	yin soul
地魂	earth soul
天魂	heaven soul
道侣	dao partner
海少	Young Master Hai
家主	clan leader
规则锁链	Chains of Regulations
准仙器	Pseudo Celestial Tool
冒兄	Brother Mao
傅通海	Fu Tonghai
傅修平	Fu Xiuping
傅冰冰	Fu Bingbing
金至宇	Jin Zhiyu
莲花落	Descending Lotus Flowers
程兄	Brother Cheng
程钟	Cheng Zhong
程家	Cheng Clan
潜龙秘境	Hidden Dragon Mystery Realm
血龙石	Blood Dragon Stones
血龙甲	Blood Dragon Armor
李旋	Li Xuan
赵名庞	Zhao Mingpang
赵庞	Zhao Pang
傅俊永	Fu Junyong
俊永兄	Brother Junyong
一重	First Heaven
九重	Ninth Heaven
二重	Second Heaven
南斗石阳水	Southern Cup Rock Sun Water
傅思远	Fu Siyuan
灵物	spiritual matter
本源之力	Source Power
九大母水	Nine Great Source Waters
三星丹师	three-star alchemist
道则	Regulations
本源	Source Power
柳怀玉	Liu Huaiyu
媚功	charm technique
海兄	Brother Hai
素女门	Purity Sect
柔	Rou
重兵阁	Massive Military Pavilion
南素玉	Nan Suyu
千赵	Qianzhao
千赵田	Qianzhao Tian
北宇家	Beiyu Clan
北宇雄	Beiyu Xiong
古雨教	Ancient Rain Sect
林芳	Lin Fang
媚术	charm techniques
九转媚体	Nine Revolutions Charm Physique
役火术	Flame Control Technique
双修	dual cultivation
傅采	Fu Cai
玄雨台	Black Rain Arena
原族爷	Elder Yuan
千赵原	Qianzhao Yuan
战舰	battle ship
天生雷体	Natural Lightning Physique
空灵仙胎	Ethereal Divine Fetus
洛长风	Luo Changfeng
紫河冰云	Zihe Bingyun
紫河家	Zihe Clan
藤森	Teng Sen
戚家	Qi Clan
傅东雪	Fu Dongxue
秘府	secret palace
韩落	Han Luo
一秘	first secret
二秘	second secret
三秘	third secret
四秘	fourth secret
五秘	fifth secret
女骑士	female knight
大教	sect
傅神兵	Fu Shenbing
雷云殿	Thundercloud Palace
血鸦族	Blood Crow Tribe
长风圣子	Holy Son Changfeng
雷神衍	Thunder God Overflow
混元石仙胎	Chaos Element Rock Divine Fetus
空灵战矛	Ethereal Battle Spear
千赵阳	Qianzhao Yang
升龙殿	Ascending Dragon Palace
无尽海域	boundless seas
火之本源	origin flames
大白兔	large white rabbit
放逐	Banish
空间规则	Regulations of Space
白魔树	White Demon Tree
魔化树心	Demonized Tree Heart
杀戮规则	Regulation of Slaughter
纸人	paper human
南宫停	Nangong Ting
半步	Pseudo
五斩	fifth severance
三重	Third Heaven
四重	Fourth Heaven
五重	Fifth Heaven
六重	Sixth Heaven
七重	Seventh Heaven
八重	Eighth Heaven
天尊	Heavenly Venerate	someone at the Heavenly Venerable Tier
灵妙	Ling Miao
偷袭	sneak attack
赤龙甲	Blood Dragon Armor
千赵家	Qianzhao Clan
万剑诀	Myriad Sword Technique
天道源石	Heavenly Dao Source Rock
天道玉	Heavenly Dao Jade
紫云家	Ziyun Clan
皇者	emperor tier
筑基玉	Foundation Jade
补缺玉	Remedy Jade
咕噜噜族	Gururu Tribe
谭卫	Tan Wei
山宝	Mountain Treasure
神圣武器	Sacred Weapon
矮人	dwarves
洞灵宝玉	Cave Spirit Treasured Jade
先天桃符	Natural Peach Seal
帝者	Monarch tier
何少鳞	He Shaolin
少鳞	Shaolin
韦年	Wei Nian
天火仙王	Heavenly Fire Celestial King
雷云仙王	Thundercloud Celestial King
紫河仙王	Purple River Celestial King
黑暗之潮	storm of darkness
火系大道	Great Dao of Fire
千赵羽	Qianzhao Yu
傅晏	Fu Yan
战舰	battleship
大人	Lord
赵凌峰	Zhao Lingfeng
紫河极	Zihe Ji
孙震	Sun Zhen
天云	Tianyun
太上长老	grand elder
管统领	Commander Guan
狐妖	Fox Demon
柳凌风	Liu Lingfeng
内丹	inner core
鲁先明	Lu Xianming
陈四	Chen Si
丹道城	Alchemy City
掌座	Chairperson
老货	old b@stard
黑煞咒	Black Murderous Curse
血影魔	Blood Shadow Demon
血影老魔	Old Demon Blood Shadow
时光修炼室	Time Cultivation Chamber
万古千秋	For All Eternity
修炼室	cultivation chamber
诸谨	Zhu Jin
喻少	Young Master Yu
刘喻	Liu Yu
苍宙城	Blue Eternity City
一星丹师	One Star Alchemist
孙东	Sun Dong
孙家	Sun Clan
小王者	Little King Tier
东少	Young Master Dong
固道丹	Dao Regulating Pill
永昌仙王	Eternal Prosperity Celestial King
永昌教	Eternal Prosperity Sect
永昌殿	Eternal Prosperity Palace
严仙路	Yan Xianlu
赵青锋	Zhao Qingfeng
紫城大师	Grandmaster Zi Cheng
保成	Bao Cheng
青锋无敌	Invincible Qingfeng
仙路	Celestial Path
锐金仙胎	Acute Metal Divine Fetus
紫城	Zi Cheng
四大天王	Four Heavenly Kings
程封云	Cheng Fengyun
程少	Young Master Cheng
山田久	Shantian Jiu
山田武	Shantian Wu
青鼎教	Black Cauldron Sect
山田家	Shantian Clan
易天河	Yi Tianhe
赤虹门	Crimson Rainbow Sect
殊	Shu
张泉	Zhang Quan
何岳	He Yue
杨碧月	Yang Biyue
鲁少	Young Master Lu
煞影	Murderous Shadow
鲁家	Lu Clan
丹童	alchemy apprentice
莫丹童	Alchemy Apprentice Mo
区侃	Ou Kan
秦古玉	Qin Guyu
丹师殿	Alchemist Pavilion
初阶学徒	beginner trainee
紫城丹师	Alchemist Zi Cheng
三星丹师	Three Star Alchemist
小莫	Little Mo
四星丹师	Four-Star Alchemist
炼灵	Spirit Refinement
一炼	First Refinement
二炼	Second Refinement
三炼	Third Refinement
四炼	Fourth Refinement
七炼	Seventh Refinement
五星丹师	Five-Star Alchemist
天心	Heavenly Heart
天心丹师	Alchemist Heavenly Heart
初叶	Chu Ye
初叶大师	Alchemist Chu Ye
五星势力	five-star force
天意铡刀	Heaven's Will Guillotine
心魔	internal demon
炼灵术	Spirit Refinement Technique
六炼	Sixth Refinement
九炼	Ninth Refinement
灵婴	Spirit Infant
二星丹师	Two-Star Alchemist
初叶丹师	Alchemist Chu Ye
石磊	Shi Lei
石玉	Shi Yu
青铜仙胎	Copper Divine Fetus
路进	Lu Jin
青云丹	Azure Cloud Pill
紫月镇魂丹	Purple Moon Spirit Suppression Pill
极品	Peak Grade
上品	High Grade
中品	Medium Grade
下品	Low Grade
高级学徒	HIgh Level Apprentice
焦邦	Jiao Bang
传音石	Sound Transmission Stone
中阶学徒	middle grade trainee
青虹丹	Green Rainbow Pill
高阶学徒	high grade trainee
霸妖	Ba Yao
问天	Wen Tian
断云山	Broken Clouds Mountain
天骄聚会	Gathering of Prodigies
清阳殿	Qingyang Pavilion
地缺晶华	Scarce Earth Essence
三阳峰	Three Yang Peak
祝雪歌	Zhu Xuege
柳飞章	Liu Feizhang
东门宏	Dongmen Hong
源蛇	Source Snake
劳松	Lao Song
山季同	Shan Jitong
源祖	Ancestral Source
祖凰	Ancestor Phoenix
七剑魔王	Seven Swords Demon King
白阳教	White Sun Sect
商达	Shang Da
剑妖族	Sword Demon Race
易无伤	Yi Wushang
古飞	Gu Fei
张云	Zhang Yun
永昌王	Eternal Prosperity King
仙道体	Celestial Dao Physique
张亚	Zhang Ya
吕海蓉	Lu Hairong
倚云仙子	Fairy Yiyun
永昌大人	Lord Eternal Prosperity
倚云仙王	Leaning Clouds Celestial King
杨弘义	Yang Hongyi
天骄	prodigy
皇甫灵	Huangfu Ling
吴存	Wu Cun
邵俊人	Shao Junren
时光流逝	Time Lapse
蛇息	Serpent Breath
王级	King Tier
源兽	Source Beast
仙王成道石	Celestial King Achieving Dao stone
祖鹏	Ancestor Roc
广隆天	Wide Prosperity Heaven
石修文	Shi Xiuwen
泰安天	Calm Peace Heaven
远南天	Far West Heaven
烈焰雷击木	Fiery Flame Lightning Strike Wood
血影虫	Blood Shadow Insects
三花谷	Three Blooms Valley
彭化年	Peng Huanian
诸丰	Zhu Feng
五炼	Fifth Refinement
四师叔	Fourth Uncle
丰源丹	Abundant Origin Pills
关化城	Guanhua City
流梭	water shuttle
普云仙王	Universal Clouds Celestial King
普云教	Universal Clouds Sect
晏伟	Yan Wei
莫霜	Mo Shuang
杨嘉	Yang Jia
地灵天泉	Earth Spirit Heavenly Spring Water
固魂丹	Soul Strengthening Pill
柳杰	Liu Jie
桂德水	Gui Deshui
诸子军	Zhu Zijun
诸少	Young Master Zhu
诸少军	Zhu Zijun	Author made a typo
冉飞	Ran fei
石永	Shi Yong
徒孙	grand-disciple
莫家	Mo Clan
莫老七	Brother Mo
卢浩名	Lu Haoming
杜绣云	Du Xiuyun
啄天功	Heaven Peck Technique
天惊	Breakthrough
诸丰大师	Grandmaster Zhu Feng
青胎丹	Azure Origin Pill
品鉴	appraise
诸家	Zhu Clan
补尘丹	Mundane Repairing Pill
柳家	Liu Clan
柳含	Liu Han
碧云丹	Jade Cloud Pill
马庸	Ma Yong
陈董	Chen Dong
凌哥	Brother Ling
玄冰教	Mysterious Ice Sect
黑炎教	Black Flames Sect
舒雅蓉	Shu Yarong
刘星	Liu Xing
萧力行	Xiao Lixing
释云天	Dispelling Cloud Heaven
四象化骨丹	Four Forms Bone Transformation Pill
四星大师	Four-Star Grandmaster
张宁	Zhang Ning
黄金巨人族	Golden Giant Race
费云	Fei Yun
死亡之镰	Death Scythe
唐明龙	Tang Minglong
纪无名	Ji Wuming
舒仙子	Fairy Shu
异	Yi
小诸天阿弥弓	Minor Heavens Complete Bow
世界树	World Tree
剑猪	Blade Hog
仙王血石	Celestial King Bloodstone
斑红青竹	Red Spotted Green Bamboo
叶林峰	Ye Linfeng
大道真解	true meaning of the great dao
灭天九剑	Heaven Destroying Nine Swords
夺天造化功	Heaven Seizing Fortune Technique
仙鹤	Celestial Crane
念力	power of belief
马路刚	Ma Lugang
肖天雄	Xiao Tianxiong
祖树	Ancestral Tree
剑法	sword technique
阳魂海	Yang Soul Ocean
生生丹	Lives Pill
马童光	Ma Tongguang
三生丹	Three Lives Pill
三都天	Three Capitals Heaven
星龙郡	Star Dragon Capital
狂人	Madman
路恒	Lu Heng
素还香	Su Huanxiang
施斌	Shi Bin
罗生原	Luo Shengyuan
明火仙王	Bright Flame Celestial King
业火	karmic flames
双瞳灭世	Twin Eyes World Destruction
魂胎	Soul Fetus
阳魂石	Yang Soul Stone
史都	Shi Du
九天火分魂	Nine Heavens Flame divided soul
墨毒王	Ink Poison King
四海宫	Four Seas Palace
商芷薇	Shang Zhiwei
七云王	Seven Clouds King
海天王	Sea Heavenly King
冥蛟	Dark Dragon
海王类	Sea King Class
秦家	Qin Clan
秦伟	Qin Wei
登途岛	Ascent Route Island
萧俊	Xiao Jun
罗河	Luo He
兰若芷	Lan Ruozhi
丰当	Feng Dang
仙灵	Deity
罡元绿金	Firm Essence Green Gold
兽潮	beast tide
兰天宇	Lan Tianyu
岛主	Island Master
九莲	Ninth Lotus
分魂	divided soul
车兄	Brother Che
兰兄	Brother Lan
兰天扬	Lan Tianyang
车元华	Che Yuanhua
教主	Sect Master
十莲境	Tenth Lotus
仙骨	Celestial Bone
五行	Five Elements
九重仙王	Ninth Heaven Celestial King
金之规则	Regulations of Metal
星月宗	Star Moon Sect
付岳	Fu Yue
郭铭	Guo Ming
付家	Fu Clan
柳雪妍	Liu Xueyan
不死丹	Undying Pill
七花七毒掌	Seven Blooms Seven Poisons Palmstrike
阮东相	Ruan Dongxiang
统连城	United Link City
八莲	Eighth Lotus
七莲	Seventh Lotus
摘月仙王	Moon Plucking Celestial King
都云仙王	Refined Cloud Celestial King
天域	Heavenly Realm
普安天	Universal Peace Heaven
灵草	Spiritual Herbs
付少	Young Master Fu
余伯	Uncle Yu
付博	Fu Bo
百龙城	Hundred Dragons City
百龙争霸战	Hundred Dragons Tournament Battles
古丹塔	Ancient Alchemy Tower
穿地船	Ground Piercing Shuttle
龙步天	Long Butian
都少俊	Du Shaojun
百龙秘境	Hundred Dragons Mystery Realm
至尊天道	Most Venerable Divine Path
天清月	Tian Qingyue
夏候通	Xia Houtong
余华青	Yu Huaqing
祝慧芸	Zhu Huiyun
本源大碰撞	Great Clash of Source Powers
龙桥	dragon bridge
大东仙王	Great Eastern Celestial King
蒲牢	Pu Lao
都牢天	Firm City Heaven
龙息	Dragon's Breath
大道之花	Bloom of Dao
断情剑	Severed Passion Sword
九字真言	Nine Figures of Truth
龙晶	Dragon Crystal
神龙山	Divine Dragon Mountain
五重仙王	Fifth Heaven Celestial King
八重仙王	Eighth Heaven Celestial King
天龙骨粉	Heavenly Dragon Bone Ashes
青龙镇	Azure Dragon Town
纳虚	Na Xu
纳空	Na Kong
龙珠	Dragon Pearl
波罗	Bo Luo
司空浩	Sikong Hao
部族	tribe
神庙	Divine Temple
青铜部族	Bronze Tribe
日扬丹师	Alchemist Riyang
药道石	Stone of Herbology
吴子虚	Wu Zixu
纳虚老和尚	Old Monk Na Xu
断龙石	Dragon Severing Stone
黑色人形	black figures
学徒	apprentice
林永昌	Lin Yongchang
元同光	Yuan Tongguang
谢乐章	Xie Yuezhang
千亿	hundred billion
龟茯苓	Tortoise Tuckahoe
勾陈	Gouchen
阿弥弓	Minor Heavens Complete Bow
玄龟厚土丹	Black Tortoise Earth Pill
虚澜	Xu Lan
宝净瓶	Treasured Tranquility Vial
时光规则	Regulations of Time
时间规则	Regulations of Time
九灯古佛	Nine Lights Ancient Buddha
佛门	Buddhist Sect
马苋	Ma Xian
范逸	Fan Yi
林承龙	Lin Chenglong
余文心	Yu Wenxin
陀罗教	Dhara Sect
阴魂谷	Yin Soul Valley
费强	Fei Qiang
艾玉	Ai Yu
石横	Shi Heng
云浪谷	Cloudy Waves Valle
金乌教	Golden Crow Sect
百龙灌体	Blessing of the Hundred Dragons
潘洛灵	Pan Luoling
黑马	dark horse
全风仙王	Full Winds Celestial King
青狼仙王	Green Wolf Celestial King
元方仙王	Yuanfang Celestial King
黑幕森林	Dark Forest
阴魂玉	Yin Soul Jade
玉潭	Jade Pool
麻云菇	Numbing Clouds Mushroom
杨晓	Yang Xiao
暴熊帮	Vicious Bear Gang
兵少	Young Master Bing
熊四	Xiong Si
君哥	Brother Jun
毒胎	Poisonous Fetus
死幽绝灭	Silent Death and Extermination
陈霜霜	Chen Shuangshuang
小程	Xiao Cheng
杨少	Young Master Yang
修炼体系	cultivation system
暴熊镇	Vicious Bear Village
黑龙王	Black Dragon King
黑龙仙王	Black Dragon Celestial King
鲲鹏天	Roc Heaven
古战场	ancient battlefield
黑暗势力	force of darkness
黑暗之力	power of darkness
玄阴母水分魂	Xuanyin Source Water Divided Soul
仙钟	Celestial Bell
青铜	bronze
永恒仙王	Eternal Celestial King
岁月钟	Bell of Time
传送门	Transference Portal
老骨魔	Old Bone Demon
霸下	Bixi
墨符	Mo Fu
大云城	Great Clouds City
孔家	Kong Clan
青柳城	Green WIllows City
虚灵琉璃	Spiritual Void Glass
孔长今	Kong Zhangjin
柳化山	Liu Huashan
盂兰风华	Yulan Fenghua
柳萧山	Liu Xiaoshan
骨魔仙王	Bone Demon Celestial King
仙王骨	Celestial King Bone
火焰本源	Source Power of Flames
空间本源	Source Power of Space
紫焰心灵火	Purple Spirit Flames
玄武混元土	Black Tortoise Chaos Origin Soil
十八莲	Eighteenth Lotus
天阳玄金	Heavenly Sun Black Gold
杀戮本源	Source Power of Slaughter
天柱	Heavenly Pillar
空间大切割	Great Spatial Cut
万华天	Ten Thousand Splendors Heaven
箭绝	Ultimate Shot
虚灵空间	Void Space
龙月惜	Long Yuexi
缘生	Yuan Sheng
倚云	Yi Yun
缘生天尊	Karmic Life Heavenly Venerable
松露晶石	Truffle Crystal
地魂山	Earth Soul Mountain
天魂池	Heaven Soul Pool
扶云长老	Elder Fuyun
三河长老	Elder Sanhe
大日天王镜	Great Sun Heavenly King Mirror
大日天王境	Great Sun Heavenly King Mirror
镜像空间	Mirror Space
镜像分身	Mirror Doppelgangers
吴恒	Wu Heng
灵岳仙王	Spiritual Mountain Celestial King
四海城	Four Seas City
安然	An Ran
林宣	Lin Xuan
陈管事	Manager Chen
付河	Fu He
广化天	Wide Change Heaven
上古	Ancient Age
上古	Ancient Age	Referring to ten epochs
远古	Primitive Age	Referring to a hundred epochs
大云仙王	Great Clouds Celestial King
失落之地	Lost Land
八部真灵兽	Eight Truths Spiritual Beast
别子文	Bie Ziwen
艾凯风	Ai Kaifeng
太易解毒丹	Highest Change Antidote Pill
钟棋	Zhong Qi
劳良	Lao Liang
狄桐欣	Di Tongxin
余开诚	Yu Kaicheng
血虫	Blood Insect
里	0.5 km	Chinese mile, in metric terms
程奕峰	Cheng Yifeng
凌月言	Ling Yueyan
凌家	Ling Clan
凌东行	Ling Dongxing
井家	Jing Clan
龙宇殿	Dragon Universe Palace
桃花源	Peach Blossom Origins
隋元良	Sui Yuanliang
赵镇	Zhao Zhen
唐涛	Tang Tao
心柳庄园	Heart Willow Estate
闻人	Wenren Clan
闻人悦	Wenren Yue
闻人创	Wenren Chuang
闻人堂	Wenren Tang
外门弟子	external disciple
核心弟子	core disciple
月冷轻阳剑	Cold Moon Light Sun Sword
真传弟子	true disciple
岳红裳	Yue Hongchang
程之龙	Cheng Zilong
雷系规则	Regulations of Lightning
拳法	fist technique
怒拳	Fists of Fury
诸旋儿	Zhu Xuan'er
闻人月	Wenren Yue
见雪	Jianxue
九华	Jiuhua
大逆仙王	Great Reversing Celestial King
大逆阴阳剑	Great Reversing Yin and Yang Sword
红樱镇	Red Blossom Village
王良春	Wang Liangchun
王师兄	Senior Brother Wang
屠三小姐	Lady Tu San
屠红英	Tu Hongying
德少	Young Master De
段大人	Lord Duan
内门弟子	internal disciple
叶建德	Ye Jiande
鸣天石	Heaven Ringing Stone
段海鸣	Duan Haiming
宫主	Palace Leader
天圣仙王	Heavenly Saint Celestial King
莫卓	Mo Zhuo
九重天仙王	Ninth Heaven Celestial King
云宝殿	Cloud Treasure Hall
八重天仙王	Eighth Heaven Celestial King
七重天仙王	Seventh Heaven Celestial Kings
天意长老	Heavenly Will Elder
欺天术	Heaven Deceiving Technique
程无崖	Cheng Wuya
井可兵	Jing Kebing
井东	Jing Dong
程荣	Cheng Rong
龙门山	Dragon's Gate Mountain
万亿	trillion
叶无海	Ye Wuhai
阴河天	Yin River Heaven
战龙殿	Battle Dragon Palace
富周	Fu Zhou
程子心	Cheng Zixin
郝新觉	He Xinjue
盟主	Alliance Leader
大威大德经	Mighty Benevolent Scroll
大威教	Great Majestic Sect
湛飞	Zhan Fei
冯兴仁	Feng Xingren
化龙诀	Dragon Transformation Technique
龙气	Dragon Qi
灭仙枪	Celestial Killer Spear
万世一指	Eternity Tap
六道	Six Samsara Realms
佛王	Buddha King
佛王	Buddha King
佛子	Buddha Son
释禅子	Shi Chanzi
佛心	Buddha Heart
天罗地网	Inescapable Net
圣源学院	Saintly Origin Academy
余青焰仙王	Residual Green Flames Celestial King
双马天	Twin Horses Heavenly Realm
丽水城	Lishui City
洪荒	Hong Huang
迦兰	Jia Lan
雨皇阁	Rain Imperial Pavilion
韩林阁	Han Lin Pavilion
柳俊	Liu Jun
帮主	Gang Leader
毛海涛	Mao Haitao
暗毒领域	Dark Poison Territory
谷玉树	Gu Yushu
筑秘丹	Secret Construct Pill
四象功	Four Divisions Technique
贾西	Jia Xi
程亮	Cheng Liang
程启	Cheng Qi
黄怡山	Huang Yishan
单浩	Dan Hao
彭姆	Peng Mu
姬旷	Ji Kuang
计玉堂	Ji Yutang
长青仙王	Everlasting Youth Celestial King
万古仙王	Eternity Celestial King
罗先生	Mr Luo
踏云	Treading Clouds
子罗	Zi Luo
纳东	Na Dong
药山	Herb Mountain
胡言	Hu Yan
齐娅	Qi Ya
荒盟	Huang Alliance
阿焚山	Burning Mountain
不灭阿焚火	Inextinguishable Burning Flam
不灭阿梵火	Inextinguishable Burning Flame
天地霸气拳	Heaven and Earth Domineering Fists
一气混元丹	Time Immemorial Pill
太宙仙体	Greatest Eternity Immortal Physique
太宙无极体	Greatest Eternity Everlasting Physique
八炼	Eighth Refinement
千秋一梦丹	Thousand Year Dream Pill
岁月长河	Timestream
九五天尊	Jiuwu Heavenly Venerate
凌火	Ling Huo
道火	Dao Flames
通天关	Clear Heaven Pass
邓利	Deng Li
厉鸿飞	Li Hongfei
聂大人	Lord Nie
帝星	Monarch Star
丁部	Unit D
聂和山	Nie Heshan
沈超	Shen Chao
陆震	Lu Zhen
梅华	Mei Hua
异族	Foreign Race
星辰月	Xing Chenyue
常家七王	Seven Kings of Chang Clan
孟非诚	Meng Feicheng
纳古仙王	Encompassing Age Celestial King
涂瑾	Tu Jin
异兽	Foreign Beast
涂景天	Tu Jingtian
常家九虎	Nine Tigers of Chang Clan
起源魔方	Origin Magic Cube
中立区域	neutral zone
卡扎隆	Gaddalon
亚姆	Yamu
十秘	tenth secret
八秘	eighth secret
十层	tenth layer
森落	Sen Luo
奈幽	Nai You
蜈心	Wu Xin
赤血	Chi Xue
十一秘	eleventh secret
九秘	ninth secret
十五莲	Fifteenth Lotus
十六莲	Sixteenth Lotus
十四莲	Fourteenth Lotus
丁部十七营	17th camp of Unit D
千古一梦丹	Thousand Year Dream Pills
六秘	sixth secret
位面	dimension
黑暗规则	Regulation of Darkness
土塔	Tu Ta
墓冷	Mu Leng
超低等位面	super low-level dimension
辛图	Xin Tu
毒系规则	Regulation of Poison
十一层	eleventh layer
赤炎	Chi Yan
赤炎天尊	Heavenly Venerate Chi Yan
柳三变	Liu Sanbian
长剑仙王	Forever Sword Celestial King
超下等位面	super low-level dimension
五重天仙王	Fifth Heaven Celestial King
十一莲	Eleventh Lotus
十二莲	Twelfth Lotus
本源魔方	Origin Magic Cube
库哈德	Kuhaad
次元宇宙	Dimensional Universe
土罕位面	Rare Earth Dimension
妖星	Demonic Star
艾里纳	Ailean
轮回之门	Reincarnation Gates
战功	military merit
天地元罡	Heaven and Earth Origin Stars
云虚	Cloud Void
千语	Thousand Words
通玄	Tong Xuan
重金	Heavy Metal
五莲	Fifth Lotus
龙图	Long Tu
云河	Yunhe
塔拉	Darla
烽火城	Fire Beacon City
恶魔族	Demon Race
天使族	Angel Race
虫族	Insect Race
圣兽	Holy Beast
安俊	An Jun
仇山	Enmity Mountain
百果树	Hundred Fruits Tree
帝非	Di Fei
帝庞	Di Pang
祖王	Ancestral King
位面战争	Realm War
玄逆位面	Dark Inverse Realm
位面	realm
元世界	Genesis World
低等位面	low-level dimension
六莲	Sixth Lotus	Tier used in the Foreign Realm
顶级位面	top-level dimension
高等位面	high-level dimension
百战学院	Hundred Battles Academy
十莲	Tenth Lotus
天使区	Angel Quarters
霸	Ba
学院	academy
霸兄	Brother Ba
云河仙子	Celestial Maiden Yunhe
寒枫	Han Feng
五叶	Five Leaf
十符宝器	Ten Symbol Treasured Tool
星	Xing	for the empress
幽源	You Yuan
千域争霸	Battle of One Thousand Territories
巽风	Xun Feng
无涯	Wu Ya
季洛	Jiluo
剑虎	Jian Hu
暴雨	Baoyu
九昂学院	Nine Soaring Academy
雍钦	Yong Qin
护腕	wrist guard
十七莲	Seventeenth Lotus
里奇那	Richina
圣山	Holy Mountain
中等位面	medium-level dimension
暴雨剑雄	Baoyu Jianhu	author accidently changed his name
独角恶魔族	single-horned demon
暗河	underground river
十三莲	Thirteenth Lotus
战兵	War Soldier
暴雨剑英	Baoyu Jianying
瓦里	Wally
战甲	precious armor
虚子能量	Void Particle Energy
进化指数	Evolution Index
战斗力	battle prowess
生命层次	level of being
记忆晶体	memory crystal
超弦	superstring
武道体系	cultivation system
恶魔区	Demon Quarters
绿原心	Lu Yuanxin
一叶	First Leaf
五叶	Fifth Leaf
碧月潮生剑	Jade Moon Lake Life Sword
幕帖儿	Mudel
初	Origin
千院战斗	Thousand Academy Tournament
千院比试	Thousand Academy Tournament
安玖	Anju
墨孤飞	Mogufi
千院大战	Thousand Academy Tournament
四华学院	Four Splendor Academy
渊	Yuan
七霜	Qi Shuang
空间通道	spatial passageway
三叶	Third Leaf
十一叶	Eleventh Leaf
怀剑	Huai Jian
恒龙学院	Eternal Dragon Academy
森平	Sen Ping
六叶	Sixth Leaf
远古战兽	Primordial Battle Beast
华平学院	Magnificent Equal Academy
七叶	Seventh Leaf
八叶	Eighth Leaf
高手榜	Elite Leaderboard
传天	Chuan Tian
庆化	Qing Hua
卷	Juan
陌	Mo
星辰瀑	Celestial Waterfall
墟星	Xu Xing
井中月	Jing Zhongyue
血戈	Xue Ge
信标	beacon
伦英学院	Excellence Order Academy
罡天学院	Firm Heaven Academy
三显学院	Three Manifest Academy
紫扬学院	Purple Flutter Academy
十叶	Tenth Leaf
九光学院	Nine Light Academy
东渐学院	Eastern Progressive Academy
天尊劫	Heavenly Venerate Tribulation
劫	tribulation
千院大比	Thousand Academy Tournament
碧龙草	Jade Dragon Herb
天地之力	power of heaven and earth
超级帝星	supreme monarch stars
体力	physical power
日落山脉	Sunset Mountains
玄逆大陆	Dark Inverse Realm
小恐	Little Terror
恒荒	Desolate Eternity
天荒山	Divine Desolate Mountain
四荒云	Sihuang Yun
风海峦	Feng Hailuan
紫霜	Zi Shuang
织空	Zhi Kong
纳华	Nahua
金云山	Golden Clouds Mountain
黄泉	Underworld
了空	Liao Kong
化剑峰	Sword Manifestation Peak
无乐天尊	Heavenly Venerate Wu Le
二步天尊	Second Tier Heavenly Venerate
九五大帝剑	Jiuwu Great Imperial Sword
万龙天凤铃	Ten Thousand Dragon Heavenly Phoenix Bells
孔令其	Kong Lingqi
孔祥	Kong Xiang
九蛇岛	Nine Snake Island
三云城	Three Cloud City
孔业	Kong Ye
孔安	Kong An
绿歌仙剑	Green Song Divine Sword
天尊宝器	Heavenly Venerate Tool
七华天	Seven Majestic Heaven
烈焰天	Scorching Flames Heaven
防御指数	Defense Index
九全	Jiu Quan
九美	Jiu Mei
黑风寨	Black Wind Faction
红果城	Red Fruit City
人贩	human trafficker
宝库	treasure chamber
孔家老祖	ancestor of the Kong Clan
青青	Qing Qing
十炼	Tenth Refinement
宝器	precious tool
位面坐标	dimension coordinate
周恒	Zhou Heng
科技位面	Technology Realm
青火	Green Flames
青火天尊	Green Flames Heavenly Venerate
超等位面	transcendent dimension
六步	Sixth Tier
六步天尊	Sixth Tier Heavenly Venerate
七步	Seventh Tier
位面卷轴	Dimension Scroll
超高等位面	transcendent dimension
道场	place of enlightenment
一步	First Tier
林洛	Lin Luo
仙种	Celestial Seed
乱天军	Luan Tianjun
乱桑	Luan Sang
乱家	Luan Clan
乱归	Luan Gui
孔霜	Kong Shuang
谢阳冰	Xie Yangbing
钱无意	Qian Wuyi
石魔王	Rock Demon King
泰家	Qin Clan
泰安	Qin An
天禁	Heaven Forbidden
苍北王	Blue North King
苍北城	Blue North City
仙树	Celestial Tree
红魔土	Crimson Demonic Earth
迷雾锁谷	Mist-locked Valley
沈浩	Shen Hao
仙体	Celestial Physique
仙草	Celestial Herb
御无敌	Yu Wudi
荣华仙王	Splendor Celestial King
苍北仙王	Blue North Celestial King
仙种印记	Celestial Seed Mark
不死海	Undead Sea
烙印	mark
水藤	water vine
东方锐	Dongfang Rui
东方兄	Brother Dongfang
玄荣	Xuan Rong
天禁	Heaven Forbidden State
火芙蓉	Huo Furong
纪兄	Brother Ji
仙种烙印	Celestial Seed Mark
天影术	Divine Shadow Skill
灰	Hui
仙果	celestial fruits
唤云城	Summoning Clouds City
唤云仙王	Summoning Clouds Celestial King
唤云	Summoning Clouds
戚远	Qiyuan
困虎峡	Tiger Caging Canyon
紫金仙棍	Violet Divine Staff
圣城	Holy City
赵雪龙	Zhao Xuelong
杨罡	Yang Gang
降紫果	Subduing Purple Fruit
钱享	Qian Xiang
九落	Ninth Descent
陆明	Lu Ming
安冥	Peaceful Underworld
红雪	Crimson Snow
朱子喜	Zhu Zixi
付圆	Fu Yuan
成涛	Cheng Tao
幽霜仙王	Dark Frost Celestial King
荀东	Xun Dong
异光	peculiar light
异香	peculiar fragrance
佛云	Buddhist Cloud
刘锡	Liu Xi
马当	Ma Dang
红雪仙王	Red Snow Celestial King
紫光	purple light
凌盟	Ling Alliance
宝塔	precious tower
仙兵	Celestial Weapon
天生	Heavenborn
本质力量	fundamental power
赵薪	Zhao Xin
武堂	Martial Hall
赵玉柳	Zhao Yuliu
心恒大陆	Etermal Heart Land
广隆镇	Grand Prosperity Town
绿荷	Lu He
赵玉柳	Zhao Yuliu
广隆镇	Vast Prosperous Town
赵薪	Zhao Xin
马运国	Fortunate Horse Nation
胡标	Hu Biao
金豹国	Golden Leopard Nation
位面传送符	Dimensional Transfer Seal
道友	friend
青日仙王	Azure Sun Celestial King
罗兴	Luo Xing
李娟	Li Juan
暗芒境	Hidden Radiance Stage
金纹蛙	golden-veined frog
云梦沼泽	Cloudy Dream Marsh
计学名	Ji Xueming
重月教	Duplicate Moon Sect
天下第一武院	World's Paramount Martial Academy
炎霜位面	Flaming Frost Realm
红花教	Red Flower Sect
空间仙器	Spatial Celestial Tool
源火	Origin Flame
安威山	Silent Might Mountain
苍茫山	Boundless Mountain
许强	Xu Qiang
汤迟	Tang Chi
多卡	Doka
杨至玄	Yang Zhixuan
战甲	Battle Armor
学员	disciple
仙王丹	Celestial King Pill
武院	martial academy
阿牧	A'mu
残月	Can Yue
杜十一	Du Shiyi
九绝阵	Nine Deaths Formation
楚浩	Chu Hao
林萧扬	Lin Xiaoyang
付乐云	Fu Yueyun
七步天尊	Seventh Tier Heavenly Venerate
三步	Third Tier
张三	Zhang San
万古石	Eternal Stone
欧阳明	Ouyang Ming
相亲会	Prospective Partner Ceremony
安阳山	Peaceful Sun Mountain
萧英雄	Xiao Yingxiong
卓凯	Zhuo Kai
宣英	Xuan Ying
乱星女神	Goddess Luan Xing
谷合义	Gu Heyi
苗化	Miao Hua
域外战场	Realm Battlefield
卓兵	Zhuo Bing
许山	Xu Shan
陈紫雨	Chen Ziyu
管东酉	Guan Dongyou
燕秋云	Yan Qiuyun
百花谱	Hundred Flowers Scroll
林幽怜	Lin Youlian
女神	goddess
武施	Wu Shi
赤红明火丹	Crimson Bright Fire Pill
苦禅	Earnest Meditation
战力榜	Battle Roll
刘豪	Liu Hao
骆阳秋	Luo Yangqiu
乾古钟	Ancient Bell of Qian
鱼龙术	Dragon Fish Technique
柳雨菲	Liu Yufei
化元归一果	United Origin Manifestation Fruit
何风仙王	Celestial King He Feng
何润海	He Runhai
何风	He Feng
许还	Xu Huan
九天星阵	Nine Heavens Stars Formations
黑驴	black donkey
不灭仙王体	Indestructible Celestial King Physique
不灭天尊体	Indestructible Heavenly Venerate Physique
永恒仙金体	Eternal Divine Metal Physique
仙王坟场	Celestial King Graveyard
鬼王都	Ghost King City
李隆	Li Long
向名	Xiang Ming
青鬼仙王	Azure Ghost Celestial King
唐远	Tang Yuan
唐明伯	Tang Mingbo
死亡竞技场	Tournament of Death
罗央	Luo Yang
血战王	Blood Martial King
升龙丹	Ascending Dragon Pill
唐少	Young Master Tang
百胜血战王	Hundred Victory Blood Martial King
千胜血战王	Thousand Victory Blood Martial King
陆离	Lu Li
陆高全	Lu Gaoquan
因波尼	Ebony
赵双	Zhao Shuang
婆罗仙花	Brahman Celestial Flower
吉志航	Ji Zhihang
九幽黄泉水	Underworld Springwater of Nine Hells
杨笑玲	Yang Xiaoling
阿猿	A'Yuan
竞技场	tournament
源火	Source Fire
胡经	Hu Jing
塞昂	Sai Ang
粒子剑	Particle Sword
李何	Li He
司马清	Sima Qing
万鬼戟	Halberd of Ten Thousand Ghouls
牛二	Niu Er
大力铁牛族	Herculean Iron Bull Race
牛大	Niu Da
阴河	Yin River
罗浮明	Luo Fuming
施渊	Shi Yuan
陆少	Young Master Lu
展飞羽	Zhan Feiyu
吉开城	Prosperous Opening City
青鬼	Azure Ghost
杨缺	Yang Que
陆高尖	Lu Gaojian
王昀	Wang Yun
罡煞环	Ring of Fiends
九化天经	Nine Transformations Divine Scroll
九化天尊	Nine Transformations Heavenly Venerate
婆罗花	Brahman Celestial Flower
赵元意	Zhao Yuanyi
二世祖	second-generation young masters
荒月盟	Desolate Moon Alliance
元古墓	Ancient Tomb
荒月	Desolate Moon
仙客居	Celestial Guest Residence
春秋盟	Seasons Alliance
万龙盟	Ten Thousand Dragons Alliance
贺义	He Yi
王东森	Wang Dongsen
三阴指	Three Yin Tap
许少	Young Master Xu
清姐	Sister Qing
刘宇恒	Liu Yuheng
天化都	Heaven Transforming City
赵清	Zhao Qing
灭魂鼓	Soul Extinguishing Drum
许方	Xu Fang
黑影	black shadow
碧精珠	Jade Essence Pearl
孔思	Kong Si
蓝月雷木	Blue Lunar Lightning Trees
雷心果	Lightning Core Fruit
青木狂雷	Azure Wood Chaotic Lightning
万高杰	Wan Gaojie
万成白	Wan Chengbai
万少	Young Master Wan
癸水怒雷	Divine Fluid Raging Lightning
天尊法	Heavenly Venerate Technique
苗英卫	Miao Yingwei
水木之雷	Lightning of Water and Wood
传承地	land of inheritance
不灭仙金体	Indestructible Divine Metal Physique
阴骨针	Evil Bone Needle
张天言	Zhang Tianyan
三雷术	Three Lightning Technique
玄青流波果	Greenish Black Flowing Ripple Fruit
赤炎风雷	Crimson Flame Windy Lightning
裴声海	Pei Shenghai
牛苍玉	Niu Cangyu
付云海	Fu Yunhai
容文林	Rong Wenlin
刁佑	Diao You
薛成白	Xue Chengbai
十煞夺魂剑	Ten Demon Soul Capturing Sword
五行雷术	Five Elements Lightning Technique
庚金之雷	Lightning of Metal
四雷术	Four Lightning Technique
五行之雷	Five Elements Lightning
元古	Primordial Ancient
元古天尊	Primordial Ancient Heavenly Venerate
虚子	Void Particle
天尊宝术	Heavenly Venerate Technique
常化云	Chang Huayun
朱宏玄	Zhu Hongxuan
千风林	Thousand Winds Forest
霍兴位面	Flash Passion Realm
王安德	Wang Ande
王千阳	Wang Qianyang
王佳月	Wang Jiayue
马玉海	Ma Yuhai
马峰	Ma Feng
王家	Wang Clan
王扬名	Wang Yangming
秦霜	Qin Shuang
大炎山	Great Fiery Mountain
何雨风	He Yufeng
天尊丹	Heavenly Venerate Pill
何荣	He Rong
破云火山	Burst Cloud Volcano
凌云天尊	Rising Clouds Heavenly Venerate
林飘雪	Lin Piaoxue
九死池	Pool of Nine Deaths
天尊符	Heavenly Venerable Seals
云傲空	Yun Aokong
云家	Yun Clan
四步	Fourth Tier
柳洋河	Liu Yanghe
柳七渊	Liu Qiyuan
云浩养	Yun Haoyang
赤炎天火石	Crimson Inferno Divine Flame Stone
天华境	Heavenly Brilliance Tier
司徒太孙	Situ Taisun
司徒太龙	Situ Tailong
刘子颜	Liu Ziyan
朱坝	Du Ba
诸葛玄明	Zhuge Xuanming
梁泰明	Liang Taiming
宇龙天尊	Universe Dragon Heavenly Venerate
辛弃虎	Xin Qihu
辛傅	Xin Fu
娄天千	Lou Tianqian
天枢	Celestial Administration
总榜	general leaderboard
壁垒	barrier
现行榜	recent leaderboard
莽牛怪	Hothead Ox Monster
赵付康	Zhao Fukang
七杀七暴丹	Seven Deaths Seven Explosions Pill
牛刀小试	Minor Skill Demonstration
苟琰	Gou Yan
铁冰河	Tie Binghe
戚长军	Qi Changjun
风云天尊	Windy Clouds Heavenly Venerate
虚云瀑布	Cloud Void Waterfall
吴昊阳	Wu Haoyang
周岩	Zhou Yan
涂石	Tu Shi
朱妍	Zhu Yan
宇波隆	Yu Bolong
吴志鸿	Wu Zhihong
异彩	iridescent light
玄莫位面	Profound Negative Realm
武晶位面	Martial Crystalline Realm
安家	An Clan
安踏云	An Tayun
许都位面	Promise City Realm
凌非凡	Ling Feifan
安平海	An Pinghai
安平天	An Pingtian
安秀儿	An Xiu'er
杨玄龙	Yang Xuanlong
杨至河	Yang Zhihe
天尊术	Heavenly Venerate Technique
祖河天尊	Ancestral River Heavenly Venerate
四夜至尊	Four Nights Heavenly Venerate
四夜天尊	Four Nights Heavenly Venerate
姜一然	Jiang Yiran
沈波	Shen Bo
非凡	Feifan
雷冰	Lei Bing
陈望云	Chen Wangyun
赵北月	Zhao Beiyue
江波	Shen Bo	Author used two names for this person
绝雷天尊	Vanishing Thunder Heavenly Venerate
一步天尊	First Tier Heavenly Venerate
玄角天尊	Mysterious Horn Heavenly Venerate
灵葫天尊	Spiritual Gourd Heavenly Venerate
灵葫	Spiritual Gourd
程飞文	Cheng Feiwen
红云天尊	Crimson Clouds Heavenly Venerate
万剑山	Mountain of Ten Thousand Swords
血参	Blood Ginseng
英烈碑	Monument of Heroes
原老大	Boss Yuan
天尊符号	Heavenly Venerable Seals
位面之力	Power of Dimension
原应龙	Yuan Yinglong
四海山	Four Seas Mountain
黑瀑山	Black Waterfall Mountain
柳十霜	Liu Shishuang
方宏典	Fang Hongdian
连正青	Lian Zhenqing
石中河	Shi Zhonghe
师梦玉	Shi Mengyu
五步	Fifth Tier
耿玄丹	Geng Xuandan
重叠	overlap
赖光	Depend Radiance
申飞	Shen Fei
武丰	Wu Feng
何立群	He Liqun
成光启	Cheng Guangqi
史宇远	Shi Yuyuan
王向荣	Wang Xiangrong
百里歌	Baili Ge
暗月枪	Dark Moon Spear
异类	anomaly
武语风	Wu Yufeng
庄非瑞	Zhuang Feirui
天王	Heavenly King
第九符	Ninth Seal
第八符	Eighth Seal
凌曦	Ling Xi
凌城	Ling City
张凯伦	Zhang Kailun
大石头	Big Rock
江飞光	Jiang Feiguang
灵宝海	Spiritual Treasure Sea
白焰	White Flames
虚空	Void
极火位面	Intense Blaze Realm
陆玄霆	Lu Xuanting
平星海	Ping Xinghai
白虎殿	White Tiger Palace
郭俊杰	Guo Junjie
柳毅	Liu Yi
第十符	Tenth Seal
郝景	Hao Jing
血泥	blood clay
罗同方	Luo Tongfang
朱雀	Vermillion Bird
第十一符	Eleventh Seal
四象天尊	Heavenly Venerate Four Directions
青龙	Azure Dragon
万影	Ten Thousand Shadows
荣新宽	Rong Xinkuan
荣天玉	Rong Tianyu
应九阳	Ying Jiuyang
荣杨	Rong Yang
荣扬	Rong Yang
组合符号	combination seals
四象符号	Four Directions Seals
四象符	Four Directions Seals
恒子	Constant Particle
介子	Mesotron Particle
纳子	Receive Particle
虹子	Rainbow Particle
夸子	Quark Particle
第十四符	Fourteenth Seal
荣家	Rong Clan
蒙东	Meng Dong
Qiu Jian	求剑
求剑	Qiu Jian
庄毕	Zhuang Bi
万兵诀	Ten Thousand Weapons Technique
毁灭天元	Destructive Heavenly Origin
应家	Ying Clan
林盟	Lin Alliance
符天行	Fu Tianxing
天尊石	Heavenly Venerable Stone
远古位面	primitive dimension
原石	raw stone
中天城	Culmination City
原石坊	raw stone lane
牛不群	Niu Buqun
赌石	stone gambling
冷修然	Leng Xiuran
冷道	Leng Dao
大云天尊	Great Clouds Heavenly Venerate
鲍风雨	Bao Fengyu
玄来大师	Grandmaster Xuanlai
岳承望	Yue Chengwang
太北天尊	Highest North Heavenly Venerate
四面天尊	Four Sides Heavenly Venerate
六壬天尊	Six Heavens Heavenly Venerate
苍空天尊	Gray Space Heavenly Venerate
紫炎天尊	Purple Flames Heavenly Venerate
断空坊	Sever Void Lane
火蚕天尊	Fiery Silk Heavenly Venerate
楼西月	Lou Xiyue
岳博容	Yue Borong
周天环	Complete Heavens Ring
二步	Second Tier
凌天华	Ling Tianhua
本质粒子	fundamental particle
宓文柏	Mi Wenbai
钱望	Qian Wang
好马不吃回头草	a good man doesn't backtrack
小菜一碟	a piece of cake
太阳从西边出来	hell freezes over
说曹操，曹操到	speak of the devil
乌鸦嘴	jinx
二百五	halfwit, pea-brain
吃一堑，长一智	a fall in the pit, a gain in your wit
睁着眼睛说瞎话	to flout reality, to tell bald-faced lies, to lie through one's teeth
近朱者赤，近墨者黑	one is marked by the company one keeps
物以稀为贵	that which is rare is dear
王婆卖瓜，自卖自夸	every potter praises his own pot
站着说话不腰疼	talk is cheap, to be an armchair quarterback
天下没有不散的筵席	all good things must come to an end
天上掉馅饼	to have something fall into your lap
巧己所不欲，勿施于人	do unto others as you would have them do unto you
睁眼瞎	a bad judge of character
跳进黄河洗不清	to be unable to clear one's name
拍马屁	to suck up to, curry favor, ingratiate
情人眼里出西施	love is blind, beauty is in the eye of the beholder
打酱油	I couldn't care less, that's above my pay grade
不怕一万，就怕万一	one can never be too careful
走着瞧	wait and see
不管三七二十一	to act recklessly, to throw caution to the wind
吃着碗里的，看着锅里的	to be unsatisfied with what one has
钻牛角尖	to split hairs, to go down a dead end
人不可貌相，海水不可斗量	you can't judge a book by its cover
林子大了，什么鸟都有	there are all kinds of fish in the sea
鸡毛蒜皮	trivial, trivalities
鲜花插在牛粪上	a beautiful woman is married to an old/ugly man
醉翁之意不在酒	to have an ulterior motive
猴年马月	god know when, it'll be a cold day in hell when
眼不见为净	what somebody doesn't know/see can't hurt them
姜是老的竦	with experience comes wisdom
得青山在，不怕没柴烧	where's there's life there's hope
拿得起，放得下	to be able to go with the flow
以其人之道还治其人之身	to give someone a taste of their own medicine, to pay back in one's own coin
走桃花运	lucky in love
成事不足，败事有余	incompetent, everything one touches turns to dust
皇上不急太监急	the person involved is calm and collected but observers are very worried
三个臭皮匠，顶个诸葛亮	two heads are better than one
脚踩两只船	to have a foot in both camps
此地无银三白两	telltale sign, methinks the lady doth protest too much
吃不到葡萄就说葡萄酸	sour grapes
心急吃不了热豆腐	more haste less speed
家常便饭	run of the mill, par for the course
癞蛤蟆想吃天鹅肉	to be out of one's league, to want to punch above one's weight
天无绝人之路	there is always a way out
走后门	get in through the back door
瞎猫碰上死耗子	even a broken clock is right twice a day
好汉不吃眼前亏	discretion is the better part of valor, you have to know when to hold'em and when to fold'em
解铃还须系铃人	he that hides can find
肥水不流外人田	one does not allow benefits created by one's own work to accrue to others
心有余而力不足	run out of steam
不分青红皂白	indiscriminate
睁一只眼，闭一只眼	to turn a blind eye
破罐子破摔	a vicious cycle
种瓜得瓜，种豆得豆	you reap what you sow
萝卜白菜，各有所爱	different strokes for different folks
狗嘴里吐不出象牙	what can you expect from a hog but a grunt
三天打鱼，两天晒网	to blow hot and cold, lack perserverance and continuity
一朝被蛇咬，十年怕井绳	once bitten twice shy
英雄难过美人关	no man can resist the charms of a beautiful woman
刀子嘴，豆腐心	to be a softie at hear, someone's bark is worse than their bite
一失足成千古恨	one false step brings everlasting grief
哪壶不开提哪壶	rub someone's nose in it
炒鱿鱼	to can someone, to give someone a pink slip
人往高处走，水往低处流	it is in man's nature to strive for better
说得比唱得好听	to speak eloquently but untruthfully
强扭的瓜不甜	you can lead a horse to water but you can't make him drink
老掉牙	tired old
搬起石头砸自己的脚	to shoot oneself in the foot
卖关子	to leave someone hanging
一分钱一分货	you get what you pay for
九牛二虎之力	a Herculean effort
敬酒不吃吃罚酒	to acquiesce to something after having refused someone's first overture
躲得过初一，躲不过十五	you can't avoid something forever, you can't keep something up forever
吃香的，喝辣的	to live in the lap of luxury
小儿科	child's play, easy
一个巴掌拍不响	it takes two to tango
牛头不对马嘴	incongrous, neither here not there
以小人之心，度君子之腹	to project one's shortcomings on someone
车到山前必有路	we'll cross that bridge when we come to it
鸡蛋里挑骨头	to nitpick, to find quarrel in a straw
吃不了兜着走	to be unable to bear the consequences of failure
打肿脸充胖子	to puff oneself up at one's own cost
三十六计走为上	to get out while the going's good
当耳旁风	to roll off like water off a duck's back
恨铁不成钢	expect better from someone
你走你的阳关道，我过我的独木桥	let's go our separate ways
过了这个村，就没这个店	it's now or never, opportunity seldom knocks twice
抱佛脚	to cram, fair weather atheists turn to god in a pinch
有钱能使鬼推磨	money talks
有其父必有其子	like father like son, the apple doesn't fall far from the tree
不见棺材不落泪	to hold out hope until faced with the grim reality
三长两短	god forbid anything should happen to someone
纸包不住火	the truth always comes out, there is no concealing the truth
好戏在后头	the best is yet to come, you ain't seen nothing yet
吹牛皮	brag, to blow smoke
欲速则不达	more haste less speed
家家有本难念的经	we all have our burdens to bear, every family has its hardships
墙头草	fence sitter
替罪羊	sacrificial lamb, scapegoat
近水楼台先得月	to enjoy the benefits of a favorable position
小巫见大巫	to pale in comparison with, doesn't hold a candle to
一不做，二不休	in for a penny in for a pound
以牙还牙，以眼还眼跑了	an eye for an eye and a tooth for a tooth
和尚跑不了庙	you can run but you can't hide
绿帽子	cuckold
识时务者为俊杰	he who understands the times is a wise man
井水不犯河水	to stay in one's own lane,mine one's own business
一棵树上吊死	to be inflexible and stubborn
放鸽子	to stand someone up, to leave someone in the lurch
一步一个脚印	to take something one step at a time
上梁不正下梁歪	a crooked stick will have a crooked shadow
不入虎穴，焉得虎子	nothing good comes without risk
赔了夫人又折兵	to suffer a double loss
有心栽花花不长，无心插柳柳成荫	to unknowingly benefit from an unexpected course of events
八字还没一撇	it hasn't even begun
有眼不识泰山	to entertain angels unawares, to fail to recognize a formidable/famous person
出气筒	punching bag
八九不离十	close to the mark, not far off
无风不起浪	there's no smoke without fire
得便宜卖乖	to not admit that one has received a benefit
不是省油的灯	a real piece of work
家丑不可外扬	don't wash dirty linen in public
背黑锅	to take the rap, to take the blame, be left holding the bag
兔子不吃寓边草	even a villain doesn't harm the next door neighbors
铁饭碗	a cradle-to-grave job
冰冻三尺，非一日之寒	Rome wasn't built in a day
远亲不如近邻	better a close neighbor than a distant brother
下马威	opening gambit, take someone a notch down, establishing an imposing air or advantageous position for oneself
天下乌鸦一般黑	they're all the same
不到黄河心不死	it's not over 'til it's over
狗急了跳墙	despair fives courage even to a coward
狗眼看人低	to have one's nose in the air, to be stuck-up
只许州官放火，不许百姓点灯	one may steal a horse while another may not look over a hedge
偷鸡摸狗	to pilfer, to philander
死马当活马医	to make a Hail Mary effort
新官上任三把火	to make drastic changes to an organization upon taking charge
对号入座	to make a connection
十万八千里	worlds apart
露马脚	to let the cat out of the bag
公说公有理，婆说婆有理	each side believes it is correct, both sides have their merits
上刀山，下火海	come hell or high water
打退堂鼓	to beat a retreat
磨刀不误砍柴工	a beard lathered is half shaved
风马牛不相及	as different night and day, to be as different as chalk and cheese
一山不容二虎	two tigers cannot share one mountain
里揉不得沙子	to not let things slide
三下五除二	in no time (flat),deftly
泼冷水	to pour cold water on
杀鸡给猴看	to throw the book at someone to set an example
生米做成熟饭	the die is cast, what's done is done
初生牛犊不怕虎	youth knows no fear
铁公鸡	miser, tightwad
无事不登三宝殿	one never visits unless they need something
马后炮	to be wise after the fact
掉链子	to fumble the ball
纸老虎	paper tiger
狐狸精	vixen, siren
丑话说在前头	let's be candid here, let's get the unpleasant/unpleasantness out of the way
半路杀出个程咬金	someone threw a wrench in the works
麻雀虽小，五脏俱全	even if something is small it can still contain the essentials
虎毒不食子	even a monster would not hurt its own children
小不忍则乱大谋	a little impatience will spoil great plans
打狗还得看主人	every action has consequences, when one beats a dog one must answer to its master
万事俱备，只欠东风	to be prepared but lack the crucial element
不管黑猫白猫，会捉老鼠就是好猫	it does not matter whether a cat is black or white so long as it catches mice
真金不怕火炼	true blue will never stain
狗改不了吃屎	the fox may grow grew but never good
杀手锏	ace in the hole, trump card
饥不择食	beggars can't be choosers
对事不对人	it's nothing personal
皮笑肉不笑	fake smile
双刃剑	double-edged sword
热脸貼冷屁股	to have someone not give you the time of day
好了伤疤忘了疼	once on shore one prays no more
醋坛子	jealous lover
君子之交淡如水	the friendship between gentlemen appears indifferent but is pure like water
三个和尚没水吃	everybody's business is nobody's business
赶鸭子上架	to force someone to put a square peg into a round hole
小白脸	pretty boy
放长线，钓大鱼	to play the long game
依葫芦画瓢	to follow suit
隔墙有耳	walls have ears
巧妇难为无米之炊	you can't make bricks without straws
不是吃素的	to be someone not to be trifled with
嫁鸡随鸡，嫁狗随狗	a woman should stand by her man
打开天窗说亮话	to lay one's cards on the table
人算不如天算	the best laid plans of mice and men often go awry, man proposes god disposes
小动作	a cheap shot, a cheap trick
远水解不了近渴	while the grass grows the horse starves
占着茅坑不拉屎	to be a dog in the manger
碰一鼻子灰	to get the cold shoulder, to be left out in the cold
死猪不怕开水烫	the situation is already so bad that to make it worse makes no real difference
换汤不换药	putting old wine in new bottles
救命稻草	a straw to clutch at
明枪易躲，暗箭难防	better an open enemy than a false friend, an open foe may prove a curse but a pretend friend is even worse
谋事在人，成事在天	man proposes god diparesis's all in god's hands now
三个女人一台戏	three women make a market four a fair
有鼻子有眼	a word picture, a vivid description
枪打出头鸟	the hunter will shoot the bird that sticks out
碰钉子	to be rebuffed
蹬鼻子上脸	to go too far
吃豆腐	to take advantage of a woman
眉毛胡子一把抓	to tackle everything all at once, to deal with everything in one fell swoop
偷鸡不成反蚀把米	to go out for wool and come back shorn
众人拾柴火焰高	little things add up, many hands make light work
快刀斩乱麻	to cut the Gordian knot
吃软饭	freeloader, to freeload
一着不慎，满盘皆输	one false move may lose the game
听风就是雨	to jump to conclusions from insignificant evidence
鸿门宴	ambush, treacherous plot
吃哑巴亏	to bite one's tongue, to hold one's tongue
眼中钉、肉中刺	a thorn in the side
舍不得孩子套不住狼	you have to spend money to make money
挂羊头、卖狗肉	to bait and switch, to cry wine and sell vinegar
煮熟的甲鸟子飞了	to slip though one's fingers
常在河边走，哪有不湿鞋	touch pitch and you shall be defiled
三脚猫	dilettantish, middling
吃闭门羹	to be left out in the cold, to get the cold shoulder
三十年河东，三十年河西	change is the only constant, the wheel of fortune turns
土包子	bumpkin, boor, hillbilly
树大招风	the winds howl around the highest peaks
酒逢知己千杯少	for a good friend a thousand toasts are too few
当一天和尚撞一天钟	to go through the motions
是骡子是马拉出来遛遛	actions speak louder than words, it's time to see what someone is worth
一个鼻孔出气	to be hand in glove
身在曹营心在汉	to not have one's heart in something
瘦死的骆驼比马大	a starving camel is still bigger than a horse
树欲静而风不止	for a situation to takes it own course regardless of someone's wishes
丑媳妇早晚也得见公婆	one is unable to avoid an unpleasant experience forever
胜者王侯败者贼	winning isn't everything it's the only thing, history is written by the victors
下三烂	low-life, low-down
上了贼船	to get in too deep, to cross the Rubicon
病急乱投医	desperate times call for desperate measures, a drowning man will clutch at a straw
打如意算盘	to engage in wishful thinking
龙生龙，凤生凤	like father like son, like mother like daughter
不看僧面看佛面	for someone's sake
雷声大、雨点小	all talk no action
脸红脖子粗	flushed with excitement/agitation, to be red in the face
一棍子打死	to throw the baby out with the bathwater
拿鸡蛋碰石头	to pick a losing battle
没有不透风的墙	two may keep counsel putting one away
人怕出名猪怕壮	fame can be a double-edged sword
山中无老虎，猴子称大王	when the cat's away the mice will play
杀鸡焉用宰牛刀	you don't need a sledgehammer to crack a nut
大树底下好乘凉	follow closely behind heavy-laden wagons
跑龙套	to be a small player, act as a utility man
七大姑，趴大姨	extremely distant relatives
一是一，二十二	to call a spade a spade
多个朋友多条路	the more friends you have the more options you have in life
下台阶	to give someone an out
打小算盘	to act in one's own self-interest
坐山观虎	sit this one out and reap the spoils later
斗羊毛出在羊身上	there's no such thing as a free lunch
一口吃成个胖子	to wave a magic wand and get what one wants
屋漏偏逢连阴雨	when it rains it pours
老油条	wily old fox, slippery one
捅马蜂窝	to stir up a hornet's nest
小意思	not a big deal, a token
倒打一耙	to play the blame game
陈芝麻，烂谷子	idle chatter
一条龙	from soup to nuts
四两拨千斤	to solve a big issue with little effort
前怕狼，后怕虎	to be afraid to commit oneself
吃水不忘挖井人	when drinking water don't forget those who dug the well
有仇不报非君子	a real man must settle his scores
不倒翁	a tumbler
干打雷，不下雨	to talk the talk but not walk the walk, all bark and no bite
鸡飞狗跳	in a tizzy
事后诸葛亮	hindsight is 20-20
落水狗	one who is down on their luck
板上钉钉	a sure bet, a shoo-in
一碗水端平	to be impartial, to take an impartial approach
烫手的山芋	a hot potato
笑掉大牙	to laugh one's head off
一回生，二回熟	a stranger is just a friend you haven't met yet
鱼与熊掌不可得兼	one can't have everything in life
咸鱼翻身	to give a new lease on life
一根绳上的蚂蚱	to be in something together
趟浑水	to intentionally get involved in a messy situation
狗腿子	lackey, henchman, lapdog
用在刀刃上	to employ limited resources where they are needed most
鸡飞蛋打	to come up empty-handed
胳膊扭不过大腿	the weak cannot contend with the strong
饱汉不知饿汉饥	the wearer knows best where the shoe pinches
笑面虎	a wolf in sheep's clothing
二	clueless
给力	awesome, exciting
母老虎	shrew
五十步笑百步	the pot calling the kettle black
门外汉	a layman
前人栽树，后人乘凉	for posterity's sake, walnuts and pears you plant for your heirs
烂泥扶不上墙	to wash a pig is to waste both water and soap
关公面前耍大刀	to teach one's grandmother how to suck eggs
高不成，低不就	to not be good enough to get what one wants but unwilling to pursue something befitting one's talents
胳膊肘往外扭	to side with outsiders instead of one's own people
长痛不如短痛	it's better to deal with painful things quickly, it's better to just rip the Band-Aid off now
酒香不怕巷子深	good wine needs no bush
一条路走到黑	to be as stubborn as a mule
不是鱼死，就是网破	it's either him or me
冰山一角	the tip of the iceberg
身体是革命的本钱	good health is a prerequisite for work
说风凉话	to crack wise
紧箍咒	to tug on the yoke, a yoke on the shoulders
唱双簧	a carefully choreographed dance, to scheme with someone
开空白支票	to make a promise one cannot keep, to write a check one can't cash
保护伞	something providing legal or political cover for someone
一个萝卜一个坑	each has his own task and there's nobody to spare
狗咬狗	dogfight
唱高调	to posture
打水漂	to make ducks and drakes of
开小差	to let one's mind wander, to zone out
两面派	double-dealer, double dealing
一盘散沙	to be in state of disunity
和稀泥	to paper over something
敲竹杠	to fleece, highway robbery
扯后腿	to hold someone back
穿小鞋	to stack the deck against someone
给他一点颜色看看	to take someone down a peg, to fix someone's wagon
天高皇帝远	when one is far away from authority the powers that be will not intervene
拣软柿子捏	to pick on an easy target
打马虎眼	to play dumb, to demur
千里马	wunderkind, prodigy
打擦边球	to push the envelope
摸着而头过河	to cross the river by touching stones
半路出家	mid-life career change
老狐狸	sly old fox
一窝蜂	a swarm
开夜车	to burn the midnight oil
手心手背都是肉	a tough call
缩头乌龟	a chicken, a coward, a scaredy cat
走过场	to go through the motions, to do something as a formality
做文章	to seize on, to make an issue of something
吃大锅饭	to be compensated without regard to performance
戴高帽	to oversell something
秋后算账	revenge is a dish best served cold
僧多粥少	too many boats chasing too few fish
坐冷板凳	to be sidelined
不当家不知柴米贵	if one is not in someone else's situation one cannot understand that person's troubles
红眼病	jealousy, the green-eyed monster
葫芦里卖的是什么药	to have something up one's sleeve
三句话不离本行	to hardly be able to talk about anything other than one's work
糖衣炮弹	Trojan Horse
树倒猢狲散	rats leave a sinking ship
硬骨头	a tough nut to crack, one tough cookie
二虎相争，必有一伤	when two tigers clash, one is sure to get hurt
拆东墙，补西墙	to rob Peter to pay Paul
大鱼吃小鱼	the law of the jungle
狐狸尾巴露出来了	to show one's true colors, the jig is up
开绿灯	to give the go-ahead
歪瓜裂枣	a troll
小辫子	chink in one's armor
一头雾水	at a loss
隔行如隔山	different professions are different worlds
一亩三分地	personal fief
成也萧何，败也萧何	one's successes and failures are both due to the same person
大水冲了龙王庙	friendly fire
乱弹琴	to speak or act without sound reason
挤牙膏	to draw something out, to be like pulling teeth
墙倒众人推	everyone kicks a man who is down
莫须有	groundless, trumped-up
拿鸡毛当令箭	to use a made-up directive to order people around
捅破窗户纸	to affirm an open secret, to address the elephant in the room
三字经	curse
苍蝇不叮无缝的蛋	to bring bad things upon oneself as a result of one's bad character
大跌眼镜	to have one's jaw drop, to be slack-jawed
说一千，道一万	there are no two ways about it
绊脚石	stumbling block
过五关、斩六将	to overcome great challenges and have the glory to show for it
求爷爷、告奶奶	to go around begging for help
羡慕嫉妒恨	to be green with envy
打掉门牙往肚里咽	to bite one's tongue
唱对台戏	to steal someone's thunder, to take the wind out of someone's sails
分一杯羹	to take one's share of the loot
变色龙	chameleon
独木不成林	a single tree does not a forest make
既生瑜，何生亮	if god made someone so excellent why did he make someone even better
撂挑子	to quit one's job, to shirk one's responsibilites
敲门砖	prerequisite for
试金石	touchstone, standard or criterion by which something is judged
火烧眉毛	the chips are down, pressing
空手套白狼	to gain something without risking anything of one's own
一瓶子不满，半瓶子晃荡	empty barrels make the most noise
脱了裤子放屁	as useless as tits on a bull
借东风	to ride the wave
白开水	vanilla
鲤鱼跳龙门	to get one's big break, carp jumping the dragon gate, advance to a point at which one's success is guaranteed
强龙压不住地头蛇	you can't beat someone on their home turf
这山望着那山高	the grass is greener on the other side
光脚的不怕穿鞋的	he who is down need fear no fall
不成功，便成仁	to win or die trying
滚刀肉	real piece of work
久病成良医	prolonged illness makes the patient a good doctor
枕边风	pillow talk
一锤子买卖	to skin the sheep
横挑鼻子竖挑眼	to do one's utmost to find the problems where there are none
唱空城计	to bluff, to not be at home
一刀切	cookie-cutter
旧瓶装新酒	new content in an old form
两面三刀	two-faced, double-dealing
一把钥匙开一把锁	there is a key for every lock
打一巴掌，给个甜枣	to throw someone a bone, to use the carrot and stick approach
先君子后小人	let's not let this get ugly
尺有所短，寸有所长	no one is perfect but no one is worthless either
出来混的，总要还的	chickens come home to roost
画虎不成反类犬	(to try to emulate something beyond one's ability and) fall flat on one's face
大意失荆州	to suffer a serious setback as the result of a careless mistake
卸磨杀驴	to kick someone to the curb when they've outlived their usefulness
躺着都中枪	to get caught in the crossfire
脚正不怕鞋歪	an honest man fears no gossip
有奶就是娘	to sell one's allegiance to the highest bidder
肉烂在锅里	it's all in the family
说你胖你就喘	flattery like perfume should be smelled not swallowed
擦屁股	to clean up someone's mess
皇帝女儿不愁嫁	sitting pretty
一朝天子一朝亞	new leaders appoint new counsellors
活人让尿憋死	to not be adaptable
走马灯	incessant turnover of personnel, revolving door, musical chairs
花无白日红	nothing good lasts forever
东风压倒西风	the good guys win
岁月是把杀猪刀	time isn't kind to anyone
丁是丁，卯是卯	to be meticulous
多年的媳妇熬成婆	to have paid one's dues and get what one deserves
强将手下无弱兵	there are no poor soldiers under an able general
头痛医头，脚痛医脚	to slap a Band-Aid on something
拉不出屎来怨茅房	a good carpenter doesn't blame his tools
东方不亮西方亮	while something isn't workable in one place it might be workable somewhere else
老牛拉破车	to trundle along
放卫星	to talk the talk,to talk big
鸡同鸭讲	whistling in the wind
一锅端	to be wiped out all at once
老皇历	anachronistic,old news
家花没有野花香	the grass is always greener (on the other side of the fence)
又想当婊子又想立牌坊	to want to be able to do immortal things while maintaining a good name
遮羞布	a fig leaf
耍花枪	to toy with someone
又要马儿跑，又要马儿不吃草	to have one's cake and eat it too
牛不喝水强按头	to impose one's will on someone
摆乌龙	made a mistake,to put one's foot in it
各打五十大板	to punish both parties equally without considering guilt
一个将军一个令	new lords new laws
抱大腿	to cozy up to someone powerful
砸了锅	to drop the ball
会哭的孩子有奶吃	the squeaky wheel gets the grease,those who complain the loudest get the most attention
二一添作五	go fifty-fifty,to split something down the middle
风一阵，雨一阵	to flit from one thing to another
剃头挑子一头热	not having any of it
远来的和尚会念经	all that is foreign must be better
揪辫子	to seize on someone's shortcomings,to get one's hooks into someone
小姐的身子丫鬟的命	a good lady with bad fortune
只见树木，不见森林	to not see the forest for the trees
屁股决定脑袋	one's position determines one's views and behavior
兔子尾巴长不了	something's days are numbered
骑马找马	to look for another job while keeping one's current position
敲锣边儿	to stir the pot
扣帽子	to paint someone as something,to call someone names
拨出萝卜带出泥	one thing brings about another
满嘴跑火车	to blow smoke,to be full of it
温水煮青蛙	to boil the frog slowly
万金油	panacea,jack of all trades
树挪死，人挪活	people unlike trees thrive on change
按下葫芦起了瓢	to be like Whac-A-Mole
到什么山唱什么歌拔	to change one's tune when talking to different people
根汗毛比腰粗	to be significantly richer or more powerful than others
阎王好见，小鬼难搪	getting past the gatekeeper is the hard part
不见兔子不撒鹰	to not commit oneself until success is certain
当面锣，对面鼓	to has things out in the open
眼大肚子小	to have eyes bigger than one's stomach
浅水养不了大鱼	a big fish needs a big pond
吃别人嚼过的馍不香	if you're not the first you're the last
起大早，赶晚集	first off the blocks but last over the line
打不着狐狸惹身骚	to wake a sleeping giant
多面手	polymath,a renaissance man/woman
鸟枪换炮	to be moving on up
矬子里拔将军	in the land of the blind the one-eyed man is king,the best house in a bad neighborhood,to pick the best out of a bad group
给个棒槌就当针	to take something too literally or seriously
捧臭脚	to lick someone's boots
咬人的狗不露齿	beware of a silent dog and still water
炒冷饭	to rehash
一只羊是赶，一群羊也是放	what's one more
虱子多了不咬，账多了不愁	worry is interest paid on trouble before it is due
攒鸡毛，凑掸子	quantity does not make up for inferior quantity
骑脖子拉屎	to treat someone like garbage
指着和尚骂秃子	thinly veiled criticism
蚂蚱也是肉	a buck is a buck
背着抱着一般沉	six of one half a dozen of the other
一言堂	an area where one person's words goes
乱拳打死老师傅	an inexperienced person defeats a master by throwing out the rules of traditions
端起碗来吃肉，放下筷子骂娘	to drink the ocean and then call it salty
出头的椽子先烂	the nail that sticks out gets hammered down
一马勺坏一锅	one bad apple spoils the barrel
终日打雁，让雁啄了眼	the hunter becomes the hunted
老鸹嫌猪黑	it's the pot calling the kettle black
别人牵驴你拨橛	to get caught holding the bag
仔卖爷田不心疼	to sell one's birthright for a mess of pottage
萝卜快了不洗泥	the hasty bitch brings forth blind puppies
接地气	grounded, down to earth
装逼	posture
牛逼	impressive, awesome
异世	alternate world
太古	primordial
上古	ancient
丈	ten feet
打量	sized up
穿越	transmigrate
紧接着	right on the heels of
放在心上	take it to heart
暗暗恼怒	seething inside
茶杯	teacup
运转	circulate
修炼	cultivate
舍利	relic
试炼者	trial-takers, cultivators
空间戒指	interspatial ring
法则	laws, nomological
法则领悟	nomological insight
周天	Heavenly Cycle
道藏楼	Dao Repository
灵丹	Spirit Pills
修行界	cultivation world
地火	Earth fire
超品	transcendent-grade
飞剑	flying sword
道符	Dao talisman
定身术	Immobilizing Spell
祸害	wreaked havoc
传音	a voice transmission
散修	itinerant cultivator
图录	totem
血髓	blood marrow
热血沸腾	ardor and zeal coursing through their blood
青龙	azure dragon
提炼	extraction
金乌	Golden Crow
神魔	Godfiend
女帝	Great Empress
随意	nonchalantly, casually, indifferently
老祖	Patriarch
老族长	Patriarch
峰	peak
师公	Grandmaster, Martial Grandfather
师爷	Grandmaster, Martial Grandfather
师姑	Aunt-Master, Martial Aunt
师叔	Uncle-Master, Martial Uncle, Aunt-Master, Martial Aunt
师博	Uncle-Master, Martial Uncle
师父	Master
前辈	Senior
晚辈	Junior
蛊	Gu
关门弟子	final disciple
亲传弟子	personal disciple
直传弟子	inherited-teachings disciple
记名弟子	in-name disciple
核心弟子	core disciple
外门弟子	outer sect disciples
内门弟子	inner sect
长老	Elder
太上长老	Grand Elder
门主	sect master
教主	sect master
弟子	disciple
公子	Young Master, Young Sir
阵盘	formation disk, array disk
洗精伐髓	Marrow Cleansing
经脉	meridians
任督二脉	conception and governor vessels
拳法	fist techniques, fist-arts
秘法	mystic technique, mystic-arts
药渣	herbal dregs
功法	cultivation technique
便宜你	you lucked out
白活	lived in vain
中土	heartlands
化形	manifestation
祖器	ancestral artifact, ancestral armament
王	prince, king, monarch
公爵	duke
侯爵	marquis
伯爵	earl
子爵	viscount
男爵	baron
离火	Li Fire
三足	three-legged
器灵	Item Spirit, Artifact Spirit
天道	Heavenly Dao
纯阴	pure Yin
纯阳	pure Yang
混沌鸿蒙	Primordial Chaos
联盟	alliance
灭世狼烟	Apocalyptic Fumes
怪不得	It was no wonder
一览	a mere glance
按照	according to the
合乎情理	well within reason
撒娇	wheedle
除了	Apart from
自幼	at a very young age
一脸无辜	gave a perfectly guileless look
游山玩水	jaunt
和睦	rapprochement
剑道	Sword Dao, path of the sword, way of the sword
孤阴不长，独阳不生	Lone Yin did not lead to birth and solitary Yang did not allow growth
太乙	Primordial Unity
乾坤袋	Cosmic Bag, Cosmos Bag, Bag of the Cosmos
魔	fiend, demon
闭关	seclusion
魔仆	demonic servant
宁静	placid
迷离	dazed
恍惚	adrift
丹田	dantian
迷蒙	misty
九婴	Nine Neonate
两败俱伤	internecine outcome
转世者	Reincarnators
君王	sovereign, monarch, overlord
空间节点	spatial node
剑意	sword intent
剑灵	sword spirit
剑魂	sword soul
悟道	enlightenment
阵法	array formation
陛下	Your Majesty
娘娘	Her Majesty
空间法则	spatial dimension laws
小丫鬟	maidservant
斜眼	looked askance
眉心	glabella, area between the brows
火系法则	fire-elemental laws
体魄	physique
吐血	vomiting blood
吞噬法则	engulfing law
中年人	middle-aged man
血脉	bloodline
顿悟	epiphany
胖子	Fatty, Fatso
战斗技巧	combat skill
防术	defensive skill
身法	movement technique
战技	offensive skill
贞洁	Chastity
节制	Temperance
慷慨	Charity
勤奋	Diligence
耐心	Patience
宽容	Kindness
谦逊	Humility
傲慢	Pride
嫉妒	Envy
暴食	Gluttony
色欲	Lust
暴怒	Wrath
怠惰	Sloth
贪婪	Greed
施主	Benefactor, Patron
会心一笑	gave a knowing smile
菩提树	bodhi tree
阿弥陀佛	Amitabha
菩萨	Bodhisattva
禅师	Zen Master
法眼	Dharma Eyes
后天	Postnatal
先天	Connate
实丹	True Core
虚丹	False Core
金丹	Golden Core
修仙人	immortal cultivator
修行人	cultivators
名妓	renowned courtesans
两银子	taels of silver
主持	abbot
庵	convent
庙	temple
寺	monastery
点头道	nodded and said
拉倒吧	forget it
手机	cell phone
救人一命胜造七级浮屠	Saving a life is better than building a seven-storied pagoda
天眼	Heavenly Eye
正道	orthodox
邪道	unorthodox
天仙	Sky Immortal
真仙	Perfected Immortal
金仙	Golden Immortal
大罗	Zenith Heaven
三千大世界	Trichiliocosm
道域	Dao Domain
道心	Dao Heart
道果	Dao Fruit
道种	Dao Seed
道树	Dao Tree
魔神	fiendcelestial
甘霖符	Drought Rainfall Charm
护甲术	Protective Armor Spell
妖魔	fiendish demon
城主	City Lord
大巫	Grand Magus
巫派	Magus Sect
巫姥	Magistress
天巫	Heaven Magus
巫女	Magus Maiden
水族	Water race
天地之力	Heaven and Earth powers
郡守	Prefectural Governor
郡	prefecture
郡城	prefectural city
县城	county city
县	county
州	state
省	province
游丝	Gossamer
御史台	Censorate
阁老	Cabinet Elder
巡按	Roving Censor
左都御史	Left Censor-in-Chief
监察御史	Monitor Censor
州牧	State Overseer
御剑飞行	Sword Kinesis Flight
技近乎道	Expertise Nearing Dao
元婴	Nascent Soul
凝气	Qi Condensation
炼气	Qi Refinement
炼虚	Void Refinement
合体	Fusion
大乘	Mahayana
渡劫	Tribulation Transcendence, surviving the tribulation, transcending the tribulation
筑基	Foundation Establishment
结丹	Core Formation
化神	Soul Formation
婴变	Soul Transformation
问鼎	Ascendant
阴虚	Void Yin
阳实	Materialize Yang
窥涅	Nirvana Scryer
净涅	Nirvana Cleanser
碎涅	Nirvana Shatterer
空涅	Ethereal Nirvana
空灵	Ethereal Spirit
空玄	Ethereal Profound
空劫	Ethereal Tribulation
天尊	Heavenly Venerate
踏天	Heaven Trampling
上仙	Exalted Immortal
仙王	Immortal King
仙君	Immortal Monarch
仙帝	Immortal Emperor
成仙	Immortal Ascension
天劫	Heavenly Tribulation
斩灵	Spirit Severing
古境	Ancient Realm
准道境	Quasi-Dao Realm
道境	Dao Realm
超脱境	Transcendence
道源境	Dao Source
至尊	Paragon
问道	Dao Seeking
祖境	Ancestor Realm
八卦	Eight Trigrams
风水	Feng Shui
阵旗	array flags
丹道	alchemy
鼎	tripod
簋	cauldron
丹药	elixirs
药草	herbs
灵草	spirit herbs
灵宝	numinous treasure
袍	robe
联姻	marriage alliance
叩头	kowtow
抱拳	cupped fists
阁	pavilion
塔	pagoda
洞府	Cave Abode
仙子	Fairy
莲花	lotus flower
掐诀	hand seals
炼	refine
時辰	two hours
兩	tael
文	thousandth of a tael (use it judiciously)
里	500 meters
斤	500 grams
寸	inch
三界	Three Realms
六道轮回	Six Paths of Reincarnation
业	negative karma
缘	fate
因果	karma
功德	merit
道	Dao
五行	Five Elements
镖局	Escort Agency
镖人	escort
内力	internal energy
点脉	striking the acupuncture points
经	sutra
吐纳	expiration
走火入魔	Qi Deviation
心魔	mental demons
初期	early-stage
中期	mid-stage
后期	late-stage
巅峰	peak
圆满	perfected
半步	half-step
灵宝山	Numinous Treasure Mountain
护法	Guardians
尊者	Supremacy
碧游宫	Green Touring Palace
鸳鸯飞剑	Lovers' Swords
黑洞	black hole
如来	Gautama
真人	Perfected
灵宝道祖	Numinous Treasure Dao Ancestor
元始道祖	Primordial Beginning Dao Ancestor
太上道祖	Grand Supreme Dao Ancestor
灵宝天尊	Heavenly Lord of Numinous Treasure
元始天尊	Heavenly Lord of Primordial Beginning
道德天尊	Heavenly Lord of the Dao and its Virtue
三清	Three Pure Ones
道人	Daoist
大世界	Great World
小世界	Small World
小成	initial success
大成	phenomenal success
虚空挪移	Void Transference
真龙	True Dragon
祖龙	Ancestral Dragon
极品	supreme-grade
上品	superior-grade
下品	inferior-grade
中品	medial-grade
大能	mighty figure
老太君	matriarch
天榜	Heaven roll
神榜	God roll
地榜	Earth roll
人榜	Man roll
老怪	Curmudgeon
摩诃	Mahākāśyapa
幽水	Nether Water
炷香	five minutes
盏茶	ten minutes
传讯印记	transmission mark
道祖	Dao Ancestor
罗汉	Arhat
法师	Venerable One
坐镇	hold down, preside over
太阳烛照	Extreme Yang Illumination
太阴幽荧	Extreme Yin Nether Glow
鲲鹏	Kun Peng
肉身成圣	Physical Establishing Sage
神隐术	Divine Concealment Spell
隐身术	Invisibility Spell
仙府	immortal abode
百花	Centaurea
药师	Apothecary
天帝	Celestial Thearch
太初	Grand Primordium
仙人	Immortal
安林	An Lin
喧嚣	Commotion
凶煞	Demonic, Fiendish
蒙	bewildered
懵逼	stupefied
目瞪口呆	dumbstruck, stunned, stupefied
圣洁无暇	holy and flawless
天籁	beautiful and heavenly, sounds of nature
天旋地转	rush of dizziness,(feel as is) the sky and earth are spinning
窝囊	vexed, annoyed, irritated, hopelessly stupid
仙风道骨	demeanour of a transcendent being
仙家气象	divine atmosphere
小伙子	young lad
宏大壮阔	grand and magnificent
彩云	Iridescent clouds
道袍	Daoist robes
太初大陆	Tai Chu Continent
天冥道体质	Tian Ming Physique
仙人	Immortal
仙女	Fairy
修仙	Cultivate
修仙联合大学	The United University of Cultivation
战神系统	God of War System
天冥道体质	Tian Ming Dao Physique
龙傲天	Long Aotian （i.e. Mary Sue）
酸爽	refreshing (sarcasm), indescribable emotion
残忍	cruel
铁棒	staff, iron club
忍不住	couldn't help but, uncontrollably
颤抖	shake, shiver, tremble
卧槽	holy f*ck
目瞪口呆	dumbstruck
咆哮	roar, scream, howl
恐惧	fear
禁不住	uncontrolled
壮汉	brawny man
发呆	dazed
诡异	abnormal
绝望	despair
就在这时	right at this moment
光团	ball of light
光球	ball of light
包裹	enveloped, shrouded
无比	unparalleled, extremely, insanely
生死交替	wavering between life and death
晕眩	dizziness
不争气	meekly, disappointing, fall short of expectations
缥缈	faintly discernible
慈爱	kindly, benevolent
涌上心头	rushed into their mind
浮现	appeared in
磕头	kowtow
施法	spell casting, perform sorcery
愣	startled, dumbfounded
失误	blunder, mistake, accident
锅	misfortune, calamity
委屈	wronged, grievances
忍受	endure
一把鼻涕一把泪	tears streaming down one's face
同情	sympathy
相逢即是有缘	to meet is fate
绝佳	exceptional, outstanding
资质	aptitude
阔绰	generous, ostentatious
热泪盈眶	tears in one's eyes
老者	elder (man)
至极	extremely
迫不及待	impatiently
一丝丝	hints of
起誓	swear, vow, make an oath
发誓	swear, vow, make an oath
不离不弃	never leave or abandon
来不及	no time to
符合	fulfill
融合	fuse
激动	moved, touched
峰回路转	turn of events
开挂系统	Hack System
开挂	add-on (games), hack
滚蛋	f*ck off
关切	concerned, considerate, worried
失态	let emotions get the better of oneself, lose control, misbehave
不堪回首	cannot bear to look back on
往事	past events
加油	make an extra effort
语重心长	meaningful and heartfelt, sincere and earnest
举荐函	letter of recommendation
欣慰	gratified, relieved
轻抚	lightly stroke, caress
同情	sympathy
腾云驾雾	ride away on the mists and clouds, ride the clouds and fly on the mist, feel giddy (or dizzy), feel as if one is floating
畅快	carefree, free from inhibitions and happy
肆	reckless, wanton, unrestrained, unbridled
感激	grateful, thankful, indebted, appreciate
挠了挠头	scratch one's head
惊疑不定	surprised and bewildered, uncertain
界面	interface
缓冲	cushion, buffer
传送	teleport
抱怨	complain, grumble
永生难忘	unforgettable
牌匾	plaque
玄妙	mysterious
看不到尽头	no end in sight
翱翔	soar, hover
仙家气象	divine atmosphere
灵兽	Spirit Beast
震惊	shock, amaze, astonish
仙境	Immortal realm
初来乍到	have just come, newcomer
彻底	completely, utterly, thorougly
猜想	guess, suspicion, speculation
掉眼泪	shed tears
关系户	Backdoor entrant
见状	seeing this
神色	expression, look
片刻	a short while, an instant, a moment
宿主	host
分贝	decibel
什么鬼	what the hell
意义	sense, meaning, importance, significance
不已	endlessly, incessantly
任何	any, whatever, whichever, whatsoever
屈辱	humiliation, mortification
低声	under one's breath, softly
载入	record
神仙	daoist immortal
奇怪	strange, odd, baffled
眼神	expression or emotion in one's eyes, meaningful glance, wink
渐渐	gradually
神经病	crazy, mental
受不了	unbearable, unable to endure, can't stand
豁	give up, sacrifice, stake all
实在	really, actually, indeed, truly, honestly
惊疑	surprised, bewildered
吓了一跳	startled
果然	as expected, sure enough
苦笑	force a smile, smile wryly, bitter laugh
反应	react, respond
本能	instinct
奇特	peculiar, unusual, strange
惊讶	surprised, astonished, amazed, astounded
高人	superior, supreme person
领地	territory, domain, estate
哇塞	wow
广阔	vast, wide, broad
话说	anyhow, speaking of which, that said, it is said
真神	True God
迷人	enchanting, bewitching, fascinating, charming, tempting
许小兰	Xu Xiaolan
石龙州	Stone Dragon State
受宠若惊	overwhelmed by an unexpected favour, feel extremely flattered
承办	organised, sponsored
九州界	Kingdom of the Nine States
向往	yearning, look forward to
惊奇	surprised, amazed, wonder
仙家	divine abode
拉风	trendy, eye-catching, flashy
驾驭	to drive, steer, handle, manage, master, tame
灵器	Spirit Tool
飞剑	flying sword
空间戒指	interspatial ring
储物法宝	storage treasure
符	talisman, seal
玉简	jade slip
刀	saber
阵	formations
精	essence
精血	blood essence
阁	pavilion
亭	pavilion
塔	pagoda
不料	unexpectedly, to one's surprise
怒目而视	glare, glower, stare angrily, look daggers at
不敢	not dare to
汇聚	flock, converge, come together
广场	plaza, public sqaure
足足	no less than, fully, as much as, extremely
围观	watch, look on
光芒	rays of light, brilliant rays, radiance
不时	from time to time, frequently, occasionally
道之体	Dao Body
段	Stage
厉害	impressive, ferocious, difficult to deal with, tremendous, awesome, devastating, severe
涌动	surge, swarm
黑线	(face) darkened
既视感	deja vu
修为	cultivation base
届	cohort
粗暴	rough, cruel, crude, brutal, rude
方便	make things convenient, to facilitate
因材施教	teach in line with a student's ability
仙剑	immortal sword
耀眼	dazzling
清雅	elegant, refined
朴素	modest, plain and simple
羡慕	admire, envy
万众瞩目	attention of a multitude of people
万众瞩目	widespread attention
淡然	tranquil and calm, indifferent
法力	magical powers
淡淡	faint, dim, dull, insipid, unenthusiastic, indifferent
竟然	unexpectedly, actually, to one's surprise, in spite of everything, to go as far as to
沸腾	seethe with excitment, to flare up
族	clan
议论纷纷	discuss spiritedly, all sorts of comment, widespread comment
妈蛋	shit, damn
灼灼的目光	intense attention
忐忑	uneasy, fidgety, restless
骑虎难下	irrevocably but unwillingly committed, in a dilemma
淡定	calm and collected
牛批	awesome, capable, arrogant, cocky
闪耀	glint, glitter, sparkle, shine, radiate
一阵	burst, fit, a spell (of time)
颤动	vibrate, quiver, tremble
紧张	nervous, tense, strained, scarce
期待	look forward to, await, expect
呆	blank, slow-witted, dull, foolish, stupid, expressionless
怀疑	doubt, skeptical, suspicion, suspect
一时	temporarily, momentary, a while
失落	sense of loss, disappointment, frustrated
空气突然的安静	everything suddenly turned quiet
踉跄	stagger, stumble
不可思议	inconceivable, unimaginable, unfathomable, disbelief
莫名	indescribable
反驳	refute, rebut, retort
知道	aware, know, realize
嘴角一抽	wince, grimace
安慰	comfort, console
忧郁	melancholy, heavyhearted, dejected, sullen, depressed
待见	like, be fond of
住所	dwelling, residence
真心	wholeheartedly, heartfelt, sincere
惊叹	exclaim in admiration, marvel at, wonder at, a gasp of surprise
不愧	be worth of, deserve to be called, to prove oneself to be
九州	Kingdom of the Nine States
福利	benefit, welfare
应有尽有	have everything one could wish for
别想了	forget about it
挺符	conform to, in accordance with, agree with, in line with
描绘	depicted
美滋滋	very happy, elated
分配	allocation, distribution, assign
划分	divide, partition
区域	district, region, area
俗话说	as the proverb says
善良	good and honest, kindhearted
热情	warm, enthusiastic, passionate
毫不介意	not mind at all
废柴	loser, good-for-nothing, trash
伙伴	companion, comrade, partner
哼	hmph, groan, snort, hum
注定	destined, bound to
霸修	dominate
刮目相看	loom with new eyes, treat with increased respect
豪气	heroic spirit, pride
仙帝	Immortal God
自信满满	self confidence, conviction, firm belief
自信	self confidence, conviction, firm belief
逆天	defiance of the natural order
境界	state, realm, boundary, level
功法	cultivation method, exercise
特殊任务	Special Missions
功法	Cultivation Methods
招式	Moves
显示	display, demonstrate, show
无奈	helpless, grudging, resignation, reluctant
达成条件	conditions	达成
不可置信	unbelievable, disbelief, incredible
任务	task, mission, assignment, duty, role
将信将疑	half believing, half doubting, skeptical
紧接着	immediately afterwards
剧痛	acute pain, severe pain, sharp pain
气	Qi, vital energy
感受	sense, perceive, feel, experience, impression
游荡	loiter, wander, roam
飘荡	drift, float, wave, flutter
气	spiritual energy
天地间	between heaven and earth
美妙	splendid, wonderful, beautiful, mesmerising
按捺	restrain, control, suppress, contain
悸动	pound, throb, palpitate from nervousness
查看	look over, examine, check up
麻蛋	shit, damn
趋势	trend, tendency
修仙联合学院	The United University of Cultivation
霸气	domineering, arrogant, intimidating, rude, unreasonable, agressive
猥琐	uncouth, wretched, vulgar
大汗淋漓	sweating profusely, drenched in sweat, dripping with sweat
猛地	suddenly, abruptly
无敌	invincible, unequalled, without rival
查看	examine, look over, check up
发现	discovered, find, detect, identify
外挂	cheat software, hack
气死	infuriate, drive crazy
巅峰	peak, pinnacle, summit, apex
乐呵呵	buoyant, happy, giddy
愣	stunned
半晌	a while, a long time
嗯	m-hm, uh-huh
拼了命	with all one's might, at all costs, as if one's life depends on it
拼命	with all one's migwith all one's might, at all costs, as if one's life depends on itht, at all costs, as if one's life depends on it
呆滞	dull, lifeless, idle
傻	dumfounded, stunned, foolish, silly, stupid, imbecile
信仰	faith, conviction, belief
万念俱灰	completely disheartened, abandon oneself in despair, become totally disillusioned, despondent
察觉	sense, become aware, to perceive, to detect
吓懵	scared sh*tless
靠	rely, trust, depend on
说不定	can't say for sure, maybe
哀叹	sigh, lament, bewail, bemoan
怀着	harbour
婀娜	graceful, elegant, lithe
显然	obvious, evident, clear
不好意思	embarrased, apologetic
矜持	reserved, solemn, aloof
主动	take initiative, willing, active
不由自主	couldn't help, involuntarily
错失良机	let slip a golden opportunity
没想	didn't expect
错愕	stunned, dumbfounded, astonished, startled
心旷神怡	relaxed and joyful, carefree and happy, untroubled, at ease
举止	poise, manner
优雅	elegant, graceful
樱	delicate, ruby-lipped
凝重	dignified, grave, imposing, heavy
气氛	atmosphere, mood
瓶颈	bottleneck, major obstacle
示意	motion, indicate, signal, hint
认真	earnest, serious
诚挚	sincere, cordial
勉强	with difficulty, reluctant
纳戒	storage ring
吐纳	expiration (cultivation)
灯火通明	ablaze with lights, brightly lit, lit up
疑问	query, question, doubt
理论	theory, principle
陌生	strange, unfamiliar
天地元气	Spiritual Energy of Heaven and Earth
导它	guide, lead, conduct
经脉	meridian (the network of vessels/channels in the body through which Qi flows. Like blood vessels, but for Qi instead of blood)
运转	operate, work, revolve
心法	cultivation method
遵循	follow, abide, adhere to, comply
规律	pattern, law, behaviour, rythym
格外	especially, particularly
积极	active, energetic, vigorous, proactive
调转	reassign, turn around, change direction, transfer, shift, manouver, mobilise
崩溃	collapse, crumble, fall apart, breakdown
不管	in any case
收获	harvest, reap, gain, profit, reward, bonus
打坐	meditate
总归	anyhow, after all, eventually
坎坷	bumpy, rugged, rough, full of frustrations
感叹	sigh, lament
专门	specially
培养	cultivate, breed, foster, nurture, educate, groom
翘楚	outstanding, talented
堆砌	piled up, pack
上品	highest grade, top grade
浓郁	rich, strong, heavy, dense, full-bodied, intense
潜移默化	imperceptible, subtle influence
阵法	formation, spell formation, battle formation
禁止	restrictions, seals, restrictive spell, spell restriction
强行	forcefully
吸收	absorbing, assimilating, ingest, recruit
恐怕	fear, dread, afraid that, perhaps, maybe
鄙视	despise, disdain, look down upon
打量	size up, look up and down
名声	reputation, repute, renown
所幸	fortunately
录取	enrol, recruit, admit, hire, accept
倒不如	it would be better to
认可	acknowledge, approve
至高无上	supreme, paramount, unsurpassed, lofty
莫大	greatest, utmost
荣耀	honorable, glorious
获	gain, obtain, acquire, achieve, win
妖孽	supremely talented
轩辕诚	Xuanyuan Cheng
初期	initial stage
育灵	Spirit Nurturing
宗主	Sect Leader
宗	Sect
仙宗	Immortal Sect
万灵仙宗	Ten-Thousand Spirits Immortal Sect
风原州	Wind Plain State
苏浅云	Su Qianyun
青木皇族	Green Wood imperial family
紫星州	Purple Star State
据说	it is said, alleged, rumoured
突破	breakthrough, surmount, overfulfil
仙班	amongst the rank of Immortals
小仙	Young Immortal
仙班	Immortal Ranks
轰动	caused a sensation, create a stir, commotion, controvesy
惭愧	ashamed
嘲讽	sneer at, taunt, ridicule
轻松	light, gentle, relaxed, effortless, uncomplicated, take things less seriously
默默	quietly, silently, unknown to the public, without attracting attention, obsure
惊呼	cry of surprise
果不其然	sure enough, just as expected
倾国倾城	exceedingly beautiful, devastatingly beautiful
贬低	belittle, depreciate, play down, devalue, demean, degrade
漠然	indifferent, apathetic, unconcerned
漠然	cold
颠倒众生	captivating
好笑	laughable, funny, hilarious, ridiculous
没好气	snapped
如沐春风	refreshing, pleasant
翩然	lightly
对此	despite this facet
稍逊一筹	slightly inferior
哀伤	grief, woe, heartbroken, distress, dejected
苍青	Cang Qing
地仙	Earth Immortal
天仙	Celestial Immortal
神采飞扬	in high spirits, glowing with health and vigour, glowing with pride and happiness
神采飞扬	exuberant
精妙	exquisite, fine and delicate
高深	profound, advanced
仙法	magical spell
津津有味	with relish, with keen interest, eager
获益匪浅	benefit
天书	illegible, incomprehensible, heavenly book
风云人物	active figure, influential figure, focal point	风云人物
华清大学	Hua Qing University
眉飞色舞	radiant with delight, smiles of exultation
阳炎	dazzling sunlight
脉	artery, vein, vessel
青藤	Ivy, vines
凝气	Vital Energy Condensation
天元	heavenly essence
术	technique
九转凝气阵	Nine Revolution Qi Condensation Spell
幽环	Tranquil Ring Technique
配合	work harmoniuosly
悠悠	unhurried, lasting for ages, long and drawn out
恍然大悟	suddenly see the light, realisation
惊人	astonishing, amazing, alarming
碾压	roll over, grind, crush
翻盘	turn the tables, make a comeback
深入浅出	explain the profound in simple terms, simple and easy to understand
生动	lively and vivid
深厚	deep, profound, solid
学渣	underachiever
身不由己	in spite of oneself, involuntarily
小弟	underling
安哥	Big Brother An
担负	shoulder, bear, undertake
重任	important task, heavy responsibility
守护	guard, defend, protect
犯	intrude, invade
主	Lord
响彻九天	resonate through the heavens
天崩地裂	rocked the heaven and earth
哀嚎	howl in grief, wail, cry piteously, anguish
不料	unexpected, to one's surprise
不妙	worried, anxious, not encouraging, look bad, not reassuring, far from good
惊	startle, frighten, scared, alarmed
失言	slip of the tongue
恐怖	terrible, frightening
威势	might, influence, power
散	emitted
笼罩	enveloped
无可奈何	no way out, utterly helpless, no alternative
猜测	guess, conjecture, surmise
猜测	suspect
精彩	brilliant, splendid, wonderful
惨	miserable, tragic, pitiful, cruel, brutal, merciless, disastrous, terrible, crushing, wretched
算	let alone, let it be, forget about it, settled
关键	critical, decisive
丢脸	shame, embarass, disgrace
拒绝	refuse, reject, turn down, decline
战书	letter of challenge
风波	disturbance, crisis
班长	class captain
凌霄	Ling Xiao
清新	pure and fresh
俊逸	handsome
迷妹	fangirl
不得不说	one has to admit
夸	praise, compliment, exaggerate, overstate, boast, brag
角逐	contend, tussle
下手	strike
新官上任三把火	A new broom sweeps clean
想来	presumably, it may be assumed, suppose
发作	flare up in anger
努力	make great efforts, try hard, exert oneself, try one's best
鼓励	encourage, urge, console
回神	recover from panic, fright, shock, daze or absent-mindedness, suddenly realize
原来	originally, formerly, at first, as a matter of face, as it turns out, actually
修行	cultivate
参照物	reference point
唉	Ah...
惹	provoke, offend, tease, irritate, incite
惴惴不安	anxious, fearful
不安	disturbed, dissatisfied, uneasy, guilty, tumultuous
通天	exceptional
刘大宝	Liu Dabao
斗胆	boldly
道友	fellow cultivator
怂包	coward
爽约	fail to keep an appointment, break an appointment
岂有此理	preposterous, absurd
算盘	scheme, plan, calculation
风光	grand, impressive, in style
机智	quick-witted, resourceful, wittingly
如此一来	in such way, like this
壮大	grow in strength, expand
可恨	detastable, abominable, hateful
太气	infuriating
悲伤	grief, sorrow, sadness
大致	roughly, approximately, more or less, vaguely
汹涌	surging, turbulent, tempestuous, raging, tumultuous
意	intent
战意	battle intent
甚至	even
看热闹	join the fun
风度翩翩	graceful, elegant
议论	comment, remark, discuss
气质	temperament, disposition, qualities, makings
风范	demeanour, poise, bearing, style, manner, air
肃穆	solemn
疾风	strong wind, gale
蹦	thump
啪	bang
哒	clatter
噗	puff
气喘吁吁	pant heavily
气喘	pant, gasp for breath, huff and puff
于是	accordingly, so, then, thereupon, hence, as a result
天才	prodigy
回过神来	recover from panic, fright, shock, or absent-mindedness, suddenly realize
后悔	regret, repent
后悔不已	overcome with regret
不由	involuntarily, can't help, can't refrain
喃喃	mutter, murmer, mumble
激烈	intense, fierce
陷入	fall into, sink into, get caught in, be lost in, land in
男神	Prince Charming
没想到	who would have thought
玷污	stain, sully, tarnish
冷静	sober, calm, quiet, deserted, still
出乎	go beyond, exceed, stem from, due to
逼	force, compel, press, pressure
自豪	pride
怒色	angry look
凛	shiver, afraid, apprehension
戒备	guard, take precautions, be alert
迸发	burst forth, burst out
仙法	immortal spell
大惊失色	turn pale with fright
亲身	personal, first-hand
威力	power, might, force
趁	take advantage, take the opportunity
嘣	bang
防备	guard against, take precautions, be prepared for
可怕	fearful, frightful, terrible, awful, dreadful
劲敌	formidable adversary, strong opponent
豪言	brave words, proud words
无表情	expressionlessly
附和	echo, chimed in
放弃	abandon, give up, renounce, forsake, abstain
放弃	relinquish
气势汹汹	fierce, overbearing
匕首	dagger
腾腾	seething, teeming, rising
纷纷	in succession, one after another
恨恨	bitterly, hatefully
气打不到一处来	filled with anger and disgust
飞剑	flying sword
脚踏	stand atop
天剑	celestial sword
释放	release, set free
风压	wind pressure
直接	direct, immediate
插手	take part, lend a hand, meddle in, poke one's nose into, inteference
亮出	suddenly reveal, flash
令牌	badge
执法	enforce
执法队	enforcement team
私自	private, secretly, without permission, illegal
斗殴	fight, scuffle
情节	plot, circumstance
恶劣	odious, abominable, disgusting, malicious, evil, foul
规定	rule, regulation
逮捕	arrest, take into custody
拘禁	take into custody, detain
拘禁室	detention room
滞	stagnant, sluggish, motionless, obstruct
滞	faltered
疑惑	uncertain, doubtful, puzzled
慷慨	vehement, fervent, impassioned, generous, liberal
就义	die a martyr
慷慨就义	die a martyr's death
荣誉	honor, glory
可惜	it's a pity, it's too bad
遗憾	regret, sorrow, remorse, pity, sorry
坑	entrap, cheat
被坑	played, been had
停息	stop, cease, subside
柔和	soft, gentle, delicate, supple
惺惺相惜	people of talent appreciate one another
感慨	sigh with emotion
无与伦比	incomparable, unparalleled, peerless, unique, without equal
效率	effiiciency
可怜	have pity on, show mercy, pitiful, pitiable, pathetic, meagre, wretched, miserable
热烈	warm, enthusiastic
及时	timely, in time, promptly, without delay
昏暗	dim
压抑	constrain, inhibit, depress, hold back, low-spirited, repressive, oppressed
潮湿	moist, damp
拘禁室	detention facility
纳闷	puzzled, bewildered
不禁	involuntarily
潸然泪下	tears trickling down one's cheek
思过	repent
鼻青脸肿	bloody nose and swollen face, badly battered, beaten black and blue
兄弟	brother
大白	Da Bai
负伤	wounded, injured
崇高	lofty, sublime, high
崇高	prestige
理想	ideal, dream, aspiration
不屑	disdain, scornful
露出	reveal, show, display
满意	satisfied, pleased, content
没出息	good-for-nothing
不服气	unsatisfied
追忆	recollect, recall, look back
追忆	reminiscence
凑	move, shuffle, gather, collect, pool
瞪	glare, stare, give a hard look, give a ferocious stare
月潭	Moon Pond
温泉	hot spring
浓郁	strong, rich, dense, thick
养颜	nourishing one's skin
育神	cultivating the mind, cultivating the spirit
坏笑	snicker, snigger, grin
难道	don't tell me
缓缓	slowly, gradually, unhurriedly
画面	appearance, frame, scenery
美不胜收	so beautiful that one can't take them all in, more beauty than one can take in
打闹	quarrel and fight noisily, play boisterously
荡漾	ripple, undulate
起伏	rise and fall, undulate
浮想联翩	thoughts run wild
微妙	delicate, subtle
巡视	patrol
仙景	paradise
难如登天啊	as difficult as ascending the heavens
妙招	clever move, clever trick, ingenious device
阁下	your excellency
虚心	open-minded, modest
得意	complacent, proud of oneself, pleased with oneself
得力	capable, competent
高傲	arrogant, proud, haughty
宝石	precious stone, gem
冰面水镜石	Ice Water Mirror Stone
贮存	store
妙	wonderful, excellent, fine, ingenious, clever
姑娘	girl
警戒	warn, admonish, precaution, guard
放心	be at ease, feel relieved, rest assured
赞叹	gasp in admiration, highly praise
赞叹不已	full of praise
崇拜	worship, adore
恭敬	respectful
苦涩	bitter, pained, agonised, anguish, forced
问题	problem, issue
气机	presence
风流	merry
风流	air current
母老虎	vixens
理想	ambition
坚定	firm, staunch, steady
肃然起敬	profound respect, admiration, filled deep with awe
拱手	join hands in salute
胆识	courage
赵怀银	Zhao Huaiyin
郑重	solemn, serious, earnest
拜了把子	become sworn brothers
拜把子	become sworn brothers
惊	exclaim
久仰	heard about you for a long time, looking forward to meeting you, pleased to meet you
返虚	Return to Void
地位	position, standing, place, status
隔阂	misunderstanding, barrier, estrangement
其乐融融	joyous and harmonious
依依不舍	reluctant to part
勇士	brave and strong, warrior
春光明媚	sunlit and enchanting scene of spring
百花盛开	a hundred flowers in bloom, luxuriant
舒畅	happy, free from worry, at ease
讨厌	dislike, loathe, be disgusted with, detest, repugnant, abominable, troublesome, nasty
后果	consequence
考虑	think about, consider
豁达	optimistic, open-minded
真诚	sincere, genuine, true
宁静	placid, tranquil, quiet, calm
漂浮	float, hover, drift
仙鹤	white crane
鸣	cry, call, ring, voice
痴痴	in a trance, in a daze
余晖	evening glow, last rays of setting sun
运气	fortune, luck
震撼	shock, shake, vibrate, stun, sensational, stir, thrill
懈怠	slack, sluggish
踏上	set foot upon
锁骨	collarbone
天鹅	swan
勾勒	draw the outline of, sketch the contour of
遗世独立	free from this world, otherworldly
至于	go as far as to
生灵	people, living beings
凡间	mortal world, secular world
激荡	agitate, surge, rage
空间传送	space teleportation gate
凡学	mortal studies
月影	Yue Ying
要求	requirement, demand, claim
盈盈	gracefully, daintily, delicately
毕竟	after all, all in all
科代表	subject representative
笑嘻嘻	grinning, smile broadly
回过神	recover from panic/fright/shock, come to one's senses, regain one's composure
清澈	clear, limpid
明媚	bright and beautiful, radiant, enchanting
骄阳	blazing sun, scorching sun
美好	fine, happy, glorious, bright, magnificent
桃花运	a man's luck in love, good luck
关注	attention, interest
接连	one after another, in a row, in succession, on end
别说	to say nothing of, not to mention, let alone
吐槽	roast, ridicule
场面	scene, spectacle, occasion
大杂烩	hodgepodge
人才	talent, person of ability, qualified personnel
革履	leather shoes
西装革履	impeccably attired
帅气	dashing, smart, graceful
高挑	tall and slender
匀称	well-proportioned
气场十足	full of vigour
严肃	serious, solemn, earnest, enforce, strict
挪开	avert, move away, shift
尴尬	awkward, difficult, hard to deal with, dilemma
下凡	descend into the mortal world
优越感	sense of superiority
骄傲	proud, arrogant, conceited, haughty
不耻下问	modestly ask subordinate
自力更生	self-reliance
轻柔	soft, gentle
儒软	soft, gentle
湛蓝	bright blue
如梦似幻	as if in a dream
诚惶诚恐	with reverence and awe, in fear and trepidation
天赋	talent, natural gift, endowment
坚持	persist, persevere, uphold, insist on, stick to, adhere to
千载难逢	once in a blue moon
错过	let slip
和煦	pleasant, warm, genial
幽兰	orchid
平缓	gentle, smooth, mild, placid
委屈	upset, aggrieved
高冷	aloof
冰山美人	icy beauty
掌握	grasp, master, know well
深刻	deep, profound
体会	feel, knowledge, understand, experience, realise
正色	stern
嫦娥	Chang'e
明媚	bright and beautiful, radiant and enchanting
击破	breach, break up, destroy, rout
心防	guard
魂不守舍	lose one's mind
广寒宫	Moon Palace
月宫	Moon Palace
捣药	pound medicine
小月	Xiao Yue
炼丹	pill refinement
天庭	Heavenly Court
懵	muddled
资格	right, qualification
悟	attain enlightment
太阴寒水	Wintry Lunar Water
青木皇宫	Green Wood Imperial Palace
随口	casually
戒备	guard, precaution, alert
娓娓	talk tirelessly
不凡	out of the ordinary, out of the common
资质	natural endowment, intelligence
不得了	no end of trouble, desperately serious, extremely, exceedingly
避免	avoid, refrain, avert, prevent
无妄之灾	unexpected calamity, undeserved bad luck
连忙	hastily, hurriedly, promptly
汗颜	blush with shame
莫非	could it be
呆	airhead
恼怒	indignant, furious, annoyed, irritated, vexed
乖巧	clever, ingenious, cute, lovely, agreeable
挣扎	struggle, attempt
挣扎	conflict
主谓宾	subject-verb-object
全神贯注	concentrate one's attention on, be absorbed or engrossed in, preoccupied with
气血翻涌	blood seething, blood surging, blood churning
意识	aware, realise, conscious
没头没脑	unthinking, without rhyme or reason, abrupt, lack coherence or logic, regardless of consequence
撩妹	flirt, hit on girls
吹弹可破	delicate
撇	curl, twitch
小巧	small and nimble
哭腔	sobbing tone
绝代风华	unsurpassed elegance and beauty
娇嗔	pout
伤人	hurtful
医务室	infrmary
突飞猛进	advance by leaps and bounds, make giant strides, rapid development
无力	feeble, weak, faint, listless
亲昵	intimate, affectionate
虚弱	in poor health, weak, debilitataed, feeble
调侃	ridicule, jeer at, deride, mock
鞠躬尽瘁	exert oneself to the utmost, spare no effort, give one's all
呕心沥血	take infinite pains, work one's heart out
药师	Pharmacist
泡汤	come to nothing, fall flat, fall through
幸灾乐祸	take pleasure in other's misfortune, gloat
看上我	not fancy
隐隐	indistinct, faint
不知不觉	unconsciously, unwittingly, before one knows
桎梏	shackle
浩瀚	vast, boundless
气劲	strength, energy, vigour, zeal, spirit, drive, air, manner, expression, interest, relish, gusto, strong, unyielding, tough
大不了	if the worst comes to the worst
犹豫	hesitate, undecided
麻烦	trouble, inconvenience, tricky
豁出去	go ahead regardless, be willling to risk anything
温和	warm, gentle
儒雅得体	learned and refined
缓和	ease, relax, mitigate, alleviate
爽朗	hearty, bright and clear
上进心	desire to do better
晶莹	sparkling and crystal clear, glittering and translucent
吸纳	absorb, attract, draw
洗涤	cleanse
迟疑	hesitate
突破	penetrate
临界	critical point
澎湃	surging, billowing, imposing, majestic, vast and mighty
水平	standard, level
发愁	worry, anxious
吐槽	complain
血脉碾压	Bloodline Intimidation
纯度	purity
领悟	comprehension, grasp
嫡传	lineal
不得已	no alternative, have to, no choice, beyond one's control
波动	fluctuate, undulate
散发	send out, issue, give out
攀升	clime, rise, go up
节节	successively, steadily
呐	stammer
激动	worked up
激动	enthusiastic, eager, thrilled, passionate, stir, trigger
激动	exhilirated
激动	animated
老实交代	own up
无妨	no harm, may as well
奚落	sneer, scoff, taunt, gibe
奚落	put down
一次次	time and time again
口无遮拦	loose tongue
免死金牌	golden ticket out of trouble
配合	coordinate, cooperate
恳求	implore, entreat, beseech
运转	utilise
猛	fierce, violent, energetic, vigorous, powerful, savage, cruel
狂暴	violent, wild, furious, raging
气流	air current, airstream
震	shake, shock, vibrate, greatly excited, deeply astonished, shocked, beat, surpass
纹丝不动	motionless
狼狈	in a difficult position, in a tight corner, be embarrassed, in sore straits, cut a sorry figure, in confusion, in panic
惟妙惟肖	remarkbly true to life, absolutely lifelike, vivid
差距	gap, disparity, difference, gulf
扑	pounce, throw, rush, attack, swoop
瞬间	in a flash, in a split second, instant
贱人	slut, bitch
毫不留情	ruthless, relentless
躲	hide, dodge, avoid
悔意	remorse
引来	attracted
玉树临风	handsome
出气	do justice, vent
连连	emphatic
来龙去脉	sequence of events, entire process
挖苦	pick at scabs
龇牙咧嘴	contorted in agony, grimace with pain
争取	strive for, fight for, win over
打算	plan, intend
瓶	bottle, vase, jar, flask
瓶	vial
涂	spread, apply, smear, scrawl
消肿	reduce swelling
怔	stare blankly, dazed
感动	move, touch
神兽	mythological beast
荒野	wilderness
温柔	gentle and soft
膏药	ointment
清凉	cool and refreshing
火辣	searing, burning
消	disappear, vanish, gone down, cool down, dispel
郁闷	gloomy, depressed
源	essence
重	stage
图标	icon
骂	scolded
班主任	home-room teacher
英雄事迹	heroic deeds
天花乱坠	extravagent and colourful, wild boast, brag extravagantly
震慑	awe, frighten
不断	non-stop, repeatedly, unceasing, constantly, continuously
气馁	become dejected, be discouraged, lose heart
布置	arrangement, decorate, fix up
技巧	technique, skill, craftsmanship, artistry
失望	disappointed
陆陆续续	in succession, one after another, continuously
低眉顺眼	submissive, meek
歉意	apology, regret
昧	hide, conceal, go against one's conscience, ignorant, bewildered
诋毁	slander, vilift, defame
解气	vent one's spleen, work off one's anger, let off pent up feelings
板	stern
诚	sincere, honest, genuine
山之精魄	Mountain Soul-Essence
特殊	special, unique
原因	reasons, circumstances
不祥	ominous, bad
望月山	Full Moon Mountain
期待	eager
魂魄	soul
灵	spirit
灵气	spiritual energy
得意	triumphant
嘚瑟	smug, cocky, show off
得瑟	smug, cocky, show off
不服气	unconvinced
不服气	unwilling to yield
哑然	soundless, silent, too surprised to utter a word, stricken speechless
恶意	malice, evil intention, ill will
深深	deep, keenly, profoundly
闷闷不乐	in low spirits, depressed
思绪万千	lost in a myriad of thoughts, myriad of thoughts well up in one's mind
思绪	train of thought, thinking, feeling, mood
山涧	mountain stream, mountain creek
泉水	spring water
奇异	unusual, strange, bizarre, unique
芳香	fragrance
酥软	limp, languid, listless
调养生息	recuperate health
聚灵	Spirit Gathering
品	rank
灵药	Spirit Medicine
天药	Heavenly Medicine
神药	Godly Medicine
珍稀	treasure, value, cherish
天丹	Heavenly Pills
珍贵	valuable, precious
攥	hold, grip, grasp, clench, clasp
嶙峋	steep, jagged, rugged, craggy
地脉	veins of the earth
清脆	clear, crisp
嘹亮	loud and clear, resonant
组成	composed, formed, make up
强劲	powerful, forceful
低沉	deep
赐予	bestow, grant
毕恭毕敬	reverent and respectful
期待	anticipte
天材地宝	extremely rare treasures
诧异	surprise, astonish
初阶	elementary rank
战神	God of War
心法	mantra
运转	activation
凝聚	condense, accumulate, gather
蕴含	contain
高耸	tall and erect, towering
凹陷	depression
道法源雷	Thunder Essence Cultivation Method
冲动	impulse, urge
冲动	desire
冲动	longing, yearning, craving
冲动	thirst, hunger
蠢蠢欲动	itch to do something, ready to make trouble
沉浸	immersed, permeated
沾沾自喜	complacent, pleased with oneself
必要	necessary, essential, required
火焰	flame, blaze
呼啸	whistle, scream, whizz
灼热	scorching hot, scalding
剧烈	violent, acute, severe, fierce
焦黑	burned black, charred black
写意	enjoyable
轻松	carefree
毫不费力	effortless, not expending the slightest effort
情绪	morale, feeling, mood, sentiment, spirits
随手	casual
普通	run-of-the-mill, normal, ordinary, average
动用	put to use, employ, draw on, utilize
天凰	Heavenly Phoenix
脉	bloodline
异常	unusual, abnormal, especially, extremely, exceedingly, particularly
自满	complacent, self-satisfied, smug
用心良苦露	pondered earnestly, give a lot of thought to
暗自	inwardly, to oneself, secretly
窃喜	secretly delighted
偷瞄	steal a glance
效果	effect, result, quality
目的	purpose, aim, goal, objective, end, target
运转	practicing
淬体	temper body
天真	innocent, naive
靠山	backer, backing, support
挫折	frustrate, foil, defeat, thwart, setback, failure
斗志	will to fight, combative spirit
抽痛	throb of pain
小腹	underbelly, lower abdomen
嗯	huh
袭击	surprise attack, raid
翻滚	churn, seethe, roll about, toss about
卫生	hygiene, health, sanitation
拉肚子	have an upset stomach, suffer from diarrhea, have loose bowels
天荒地老	for all eternity, till the end of the world
伴随	accompany, follow
念头	thought, intention, idea
幽幽	faintly, quietly, dim, indistinct, looming in the distant
寻思	consider, ponder
挪	move, shift
监禁室	detention facility
颦	knit the brows, scowl, frown
分泌物	discharge, secretion
产生	produce, give rise to, bring about, emerge
强烈	strong, intense, violent, clear-cut, striking, sharp
作弄	tease, make a fool of, play a trick on, poke fun at
慈悲	mercy, benevolence, pity
活蹦乱跳	skip and jump about, frolic, lively
免疫	immune
尝试	attempt, try
推翻	overturn, overthrow, topple, repudiate, cancel, reverse
猜测	speculation
难道	could it be
省心	save worry, easy, effortless, trouble free
也罢	well, alright, never mind, fine, whether...or...
废	waste, useless, disused, disabled, cripple
念头	urge
枯槁	haggard, shrivelled, withered, without energy
萎靡	listless, dispirited, depressed, downcast
愧疚	guilt, remorse, ashamed
开发	pay, distribute, develop, open up, exploit, tap, bring into plan
血气	animal spirits, sap, vigour, courage and uprightness, blood and vital breath, bloodline, valor
补充	replenish, supplement, complement, fill up
贵重	valuable, precious, costly
血色	redness of the face, color
清明	clear and bright, sober and calm
勉强	inadequate, unconvincing, strained, far-fetched, grudging, manage with an effort, barely enough
松了一口气	heave a sigh of relief, breath a sigh of relief
状态	state, condition
心知肚明	to be well aware
追究	look into, find out, investigate
特意	specially, intentionally
决心	make up one's mind, resolute, determined, make a firm resolution
吊车尾	lowest-ranking student, rank at the bottom, finish last, straggler
一窍不通	know nothing about, utterly ignorant of, clueless
炼器	tool refinement
手法	skill, technique, trick, gimmick
基础	foundation, base, basis
自由之战	free-for-all battle
盛事	great event, grand occasion
盛	flourishing, prosperous, vigorous, energetic, magnificent, grand, popular, common, widespread, abundant, plentiful
届时	when the time comes, at the appointed time, on the occasion
热闹	lively, bustling, jolly, bustle and excitement
刺激	stimulate, encourage, provoke, irritate, upset, excite
千峰林	Forest of One-Thousand Peaks
神识	divine sense
学长	senior student
抵御	resist, withstand
惊悚	frightening, horrifying
寒意	chill
荡然无存	all gone, nothing left, vanished
评定	evaluate, assess
仙榜	Immortal Rankings Board
干劲十足	full of vigour
干劲	drive, enthusiasm, vigour
基本	generally, mainly, by and large, basically
奢望	wild wishes, extravagant hopes, high hopes, excessive expectations
牛逼	badass, freaky, awesome, capable
担任	assume the office of
担任	hold the post of
震撼人心	stirring, thrilling
汇集	converge, assemble, flock together
白玉广场	White Jade Plaza
矛盾	conflict, contradict, difference, inconsistent
纠葛	entangle, dispute
光明正大	fair and square
揍	beat, pummel, pommel
飘逸	graceful, elegant
眷顾	blessed
老天爷	god, heavens
概念	concept, notion, idea
直观	directly perceived
身临	personally on the scene, be present on the scene
悦耳	sweet-sounding, beautiful, pleasant to the ear
副校长	Vice-Principal
玉华	Yu Hua
瞻仰	gaze at with reverence, to revere, admire
伟大	great, mighty, grand, huge
负手	hands clasped behind back
仿佛	seemingly, as if, alike, similar
穿透	pierce through, penetrate, run through
心灵	heart, soul, spirit
能力	ability, capacity, capability
如雷贯耳	reverberate like thunder, resounded in one's ears
感叹	exclaim
如痴如醉	as if intoxicated and stupefied, obsessed with, mad about
总结	summary, sum up, review
监视	mointor, survey, watch over, keep a lookout over
残酷	ruthless, cruel, brutal, harsh
促使	impel, urge, spur
嗨	high, hyped up
战败评定符	Defeat Judgement Seal
话语	utterance, speech, words, discourse
激昂	excited and indignant, roused, impassioned, worked up
启动	activate, start, switch on, open up, launch
禁地	forbidden area, restricted area, out-of-bounds
荒凉	bleak and desolate
荒凉	wild
冷冽	ice-cold, biting, chilly
屏障	screen, barrier
迅速	rapid, swift, speedy, fast
检测	test, examine, check up, detect, sensing
发布	issue, release, announce, distribute
任务成功	Mission Success
任务失败	Mission Failure
注	Note
深知	know very well, fully aware, keenly aware
单调	monotonous, dull, drab
轰鸣	roar, boom, rumble
赶	hurry, rush, catch up, overtake, make a dash for, drive away, expel
此时	this moment, right now
硬着头皮	brace oneself, force oneself to, against one's will, summon up courage
硬着头皮	muster courage
大笑	laugh heartily, roar with laughter
名人榜	Famous Persons Register
深仇大恨	bitter and deep-seated hatred, profound hatred
爆发	erupt, burst out, break out, explode
杀气	killing intent
安全感	sense of security
脑补	to imagine, to visualize
仗义	uphold justice, loyal, generous and ready to offer help, to stick by
阴沉	cloudy, overcast, gloomy, sombre
流星锤	meteor hammer
丧心病狂	freanzied, frantic, perverse, deranged, demented, beserk
欣喜	glad, joyful, happy
校园名人榜	University Famous Persons Register
木然	stupefied, dazed, in shock
别样	unique, different
宽慰	console, comfort, soothe
寒光	dazzling gleam
意外	accident, mishap
罪大恶极	guilty of the most heinous crimes, guilty of terrible crimes, reprehensible
溜	sneak off, slip away
担忧	worry, anxious
瑟瑟发抖	shiver
认同	identify, approve, acknowledge, endorse, recognise
不甘	unreconciled to, not resigned to, unwilling, refuse to accept
凭什么	why, for what reason
占据	occupy, hold
挣扎	toil
侮辱	insult, humiliate, harass, dishonor
敢情	So it turns out, as a matter of fact
过河拆桥	to kick someone to the curb when they've outlived their usefulness
邪	heretic, heretical, evil, sinister
风度	demeanor (elegant), grace, poise
收	receive, accept, put away, collect, gather, harvest, stop, bring an end, restrain, control
简直	simply, sheer, at all, practically
亲密	close, intimate
不得不	have no choice(option) but to, can't help it, can't avoid
熊熊烈火	raging flames, fiery fire
勃然大怒	flare up, fly into a rage
仰慕	look up to, admire
征服	conquer, subjugate, vanquish
忍	bear, endure, tolerate, put up with, stand, to restrain oneself, have the heart to
饥渴难耐	unbearable hunger and thirst
嫉恨	envy and hate, hate out of jealousy, resent
招来	attract, incur
痛斥	bitterly attack, scathingly denounce, rebut, refute, critisize harshly, attack viciously
罪行	crime, guilt, offense
惊天动地	shake heaven and earth, magnificent and earth-shaking feat
吸引	attract, draw, fascinate
忍痛割爱	part reluctanty with what one treasures
吸引	intrigue
忘怀	forget, dismiss from one's mind
错过	miss, let slip an opportunity, fault, mistake
了结	finish, settle, bring to an end
仇恨	hatred, enmity, hostility
夺走	snatch away
挚爱	true love, love dearly
肃然	respectful, solemn, awed
不依不饶	not let off, mot overlook, not spare, unwilling to forgive, treat severely without listening to excuses
纠纷	dispute, issue
纠纷	quarrel
弥漫	suffuse, fill the air, brim over, spread all over, pervade, permeated
逆袭	counterattack
悬浮	float, suspend
啧	tsk
体面	dignity, face, keep up appearances, honorable, creditable, decent
目光炯炯	flashing/bright/piecing eyes
地域	area, region, district
团团围住	completely surrounded, encircle
气势汹汹	fierce, truculent, overbearing, aggressive
抽签	draw lots
跃跃欲试	eager to have a try, itch to have a go
愉快	happy, joyful, cheerful, delightful, pleasant, pleasing, happy
类型	type, category, genre, form, style, ilk
残影	afterimage, shadow
霸道	strong, potent
不相上下	equally matched, about the same, on par
暗藏	hide, conceal
绝招	unique skill, last resort, masterstroke, finishing blow
耗费	waste, spend, consume
灵力	spiritual energy
缠绕	twine, wind, bind
粉碎	crushed, smashed, shattered, pulverized
功能	function, capability
枯竭	dried up, exhausted, used up, depleted
绰绰有余	more than sufficient, enough and to spare
磅礴	boundless, majestic
轰然	loudly, with a loud crash, a loud rumble
轰击	bombard, shell
噗	pfff
滚落	tumble
俯视	look down at, overlook
遗憾	disappointment
蔑视	loathe, despise, contempt, scorn
姗姗来迟	slow in coming, be late, arrive slowly
料到	forsee, anticipate, expect, predict
抵抗	resist, stand up
快感	pleasure, thrill, delight, joy
疯	mad, insane, crazy, wild
循环	cycle, circulate, loop
战力值	Combat Capability
功勋	achievement score
开挂	unbelievably good, cheating
体质	physique, constitution
大展神威	display one's invincible might
对决	confrontation, contest, showdown
对决	clash
认定	maintain that, determine, firm opinion, believe firmly, set one's mind on, identify with
补刀王	Last Hit King
急切	eager, impatient, in a hurry, in haste
豪迈	bold, open-minded, heroic, pridefully
灼灼	shining, brilliant, keen/sparkling eyes
恳求	plead
消耗	consume, expend, depleted, use up
稀缺	in short supply, scarce, in pressing demand
地莲神功	Earth Lotus Supreme Skill
黑石峰	Black Rock Peak
境界	rank
魔法	mage
补刀	last hit
残血	critically injured
破口大骂	let loose a torrent of abuse
厚颜无耻	impudent, brazen, shameless
束缚	tie, bind, restrict
扩散	spread, proliferate, diffuse, spread
积蓄	accumulate, build up
无敌	unmatched
终极	ultimate, final
贯穿	run through, penetrate, connect, cross, link
打散	break up, scatter, beat
苦恼	vexed, worried, tormented, afflicted, distressed
技能	ability, skill
华丽	magnificent, gorgeous
曼妙	lithe and graceful
尽快	as soon as possible
自知之明	self-knowledge
何况	let alone, besides, what's more, to say nothing of
气息	aura
收敛	restrain, hold back, weaken, curb, dwindle, contain, control, restrict
打气	pump up, inflate, encourage, boost morale
残忍	mean, merciless, ruthless
直觉	intuition, instinct
潜能	latent energy, potential ability, hidden capability
汇聚	gather
威胁	threaten, menace
惊愕	stunned, stupefied, shocked, amazed, astonished
光之束缚	Light Binding
终极闪光	Final Spark
懵	stupefied, dumbfounded
懵	baffled
王者荣耀	Arena of Valor
英雄联盟	League of Legends
慌	panic, alarmed, confused, flustered
依旧	as before, unchanged, still
积累	accumulate, cumulate
鼓起勇气	muster one's courage
无厘头	whimsical, capricious, inexplicable, incoherent, illogical
含义	meaning, implied meaning, hidden meaning, hint, connotation
立flag	jinx
诡术妖姬	LeBlanc the Deceiver
嘟	pout
幽怨	sulky, indignant, angry, embittered, resentful
嘟囔	mutter, mumble
稳住	remain calm, stabilize, stay in control, maintain one's position
补刀	killing blow
水晶	Nexus
光辉女郎	Lady of Luminosity
血量	health
恶意魔印	Sigil of Malice
幻影锁链	Ethereal Chains
魔影迷踪	Distortion
故技重施	Mimic
驱逐	drive out, expel, banish, deport, dispel
中二	chuunibyou
中二	delusional
中二	childish
嗖	whiz, whoosh
有惊无险	threatening but not dangerous, more scared than hurt
节操	integrity, moral principle
顾名思义	As the name implies
既然	since, as, now that, since it is so, that being the case
科学	rational
科学	logical
科学	reasonable
不科学	illogical, unreasonable, foolish, ridiculous, absurd, nonsensical
忍	suppress
懒腰	stretch lazily
纤细	thin, slender, fine, tender, slim
眉开眼笑	be all smiles, beam with joy
手残党	noob
势均力敌	evenly matched, close contest
就这样	just like that
光幕	curtain of light
遁光术	Light Concealment Spell
固定	fix, fasten, regular, set rigidly, set
固定	steady
紧张	anxious
怯	timid, cowardly, nervous, afraid
六羽法杖	six-feathered staff
几乎	almost, nearly, practically
魔法少女	young sorceress
腿发软	go weak at the knees
双宿双飞	always keep each other's company, to be inseparable, like birds flying and nestling together
柳千幻	Liu Qianhuan
算了	let it be, let it pass, forget about it
观察	observe, watch, survey, examine, view
关于	with regard to, about, concerning
糟糕	terrible, bad, bad luck
恐高症	acrophobia
恐速症	tachophobia
修士	cultivator
清秀	fine and delicate
纯净	pure, clean
少年	youth
敌意	animosity, hostility, enmity
清净	peaceful and quiet, tranquil, serene
请赐教	please enlighten me
怔	stumped, stunned
陈尘	Chen Chen
毫不留情	mercilessly
无声无息	silent, quiet, noiseless, unknown, obscure
倒霉	lousy luck, be out of luck
话说	say
别的不说	Not taking into account other matters
一流	first-rate, first-class, top-notch
事件	incident, event
体力	stamina, strength, physical power
悠然	carefree and leisurely, unhurried
淬炼	temper
专属	exclusive
惨遭	to suffer
蹂躏	ravaged, devastated, trampled on, violated
秒杀	rapid dispatch of an opponent
呼	phew
疲惫	beat, exhausted, tired
麻木	numb, insensitive, apathetic, empty, lifeless, paralysed
秒杀	insta-kill
承认	admit, concede, recognize, acknowledge
哉悠	free and unconstrained, leisurely and carefree
纹路	veined patterns
玄妙	mystical
顿悟	flash of realization, moment of enlightment
脱线	bizarre
暗合	in accordance with
无奈	exasperated
无奈	frustrated
不假思索	readily, without hesitation
浮现	emerge, float
具体	concrete, definite, specific
修炼	practice
必然	inevitably, certainly, necessity
意外	surprised, astounded
看不起	look down on, scorn, disdain, despise
看不起	condescending, contemptuous
厌恶	disgust, hate, loathe, contempt
呵	heh	scornful chuckle
冷笑	sneer, laugh grimly, laugh scornfully
急剧	rapid, sharp, sudden
绝招	special move, ultimate skill
不觉	imperceptible
颤颤巍巍	tremble, sway, flicker, falter
骇然	gasp with astonishment, dumbstruck, aghast, overwhelmed with shock
引发	triggered, initiate, cause, evoke
一般来说	Generally speaking
琢磨	ponder, mull over, think through
土拨鼠	marmot
面目全非	beyond recognition
悲愤	grief and indignation
义气	loyal, faithful
激将法	tauting, goading, prodding
有一套	savvy, have a skill, know how to do
好胆	what audacity, have the guts
迄今为止	so far, up to now
压迫	oppress, repress, constrict
喷薄	gush, squirt, surge
大道	Great Dao
撕心裂肺	heart-wrenching
噗通	plop, thump
荒谬	absurd, ridiculous, preposterous
护体金光	golden defensive barrier
遗憾	unfortunate
遗言	last words, words of the deceased, wisdom of the past sages
土拨鼠	groundhog
命缘剑仙	Destiny Sword Immortal
莫名其妙	mysteriously, inexplicably, oddly, baffled, unfathomable
扭转	reverse, turn back
因果	karma, preordained fate
回荡	reverberate, resound, echo
气息	presence
异象	phenomenon
百思不得其解	puzzled, perplexed
兽丹	Beast Core
影	projection
散发	exude
生机	vitality
神采奕奕	as fit as a fiddle, beaming and buoyant in spirits
反正	in any case, at any rate, anyway
呸	bah
鄙夷	look down upon, despise, disdain
晋升	advance, promote
桎梏	shackle
炯炯有神	bright and piercing
不悦	displeased, irritated, annoyed
命缘仙人	Destiny Sword Immortal
缓解	alleviate, relieve, ease
御狗	Dog Kinesis Flight
神兽宗	Mythological Beast Sect
收获	fruitful, rewarding
凛	serious, grim, stern
讷讷	slow of speech, faltering in speech, mumbling, hesitating
育灵期	Spirit Nurturing Stage
尽管	despite, even though, feel free to, not hesitate to
高明	wise, brilliant
召唤兽	Summoned Beast
回想	recollect, recall
支配	arrange, allocate, budget, control, dominate, dominate, govern
一跃而起	spring to one's feet
合理	reason, rationality, rationale
水晶	crystal
王玄战	Wang Xuanzhan
后期	final stage
深不可测	unfathomable
育灵后期	Spirit Nurturing Final Stage
育灵初期	Spirit Nurturing Initial Stage
育灵中期	Spirit Nurturing Intermediate Stage
虚脱	drained, exhausted, sapped, worn out
情况	circumstance, situation, condition, state of affairs
恐怖	startling, alarming, horrifying, terrorizing
惊人	devastating
恐怖	devastating
神脉	divine bloodline
精纯	pure, exquisite, superb
破绽	flaw, weak point
进行	carry out, conduct, progress, proceed, commit, wage
无能为力	helpless, powerless, incapable of action
融为一体	fused together
目的	intention
不言而喻	goes without saying, self-evident
这时	at this time
这时	at this moment
究竟	after all, anyway, finally, actually, outcome, result
断定	concluded, decided, determined, came to a judgement
觉醒	awaken
傲然	dignified and proud, unyielding
血腥	bloody, sanguinary
强悍	fierce, intrepid, valiant
关注	follow with interest, pay close attention to, follow closely
关注	focus on
凭借	rely on, depend on, thanks to, by means of
火爆	fiery, popular, flourishing, prosperous, lively
套路	sequence of moves, routine, system
纵然	even if, even though
狂风暴雨	heavy rain storm and strong gale, howling wind and torrential rain, difficult, dangerous situation
蓄	store up, save up, charge
发泄	vent, let off, release
耿直	honest and frank, upright
承受	bear, support, endure, inherit
流传	spread, circulate, hand down
天资	talent
卓越	unsurpassed, extreme, of the highest degree
千奇百怪	all kinds of strange things, an infinite variety of fantastic phenomena, fantastic oddities of every description
断绝	break off, cut off, sever, discontinue
缓	ease, relaxed, slow, unhurried, sluggish, gradual, defer, revive, recuperate
烦躁	fidgety, agitated, irritated, jittery, twitchy
怒火	fury, rage, anger, wrath
阻碍	hinder, block, impede, obstruct
憋屈	distressed
这可是	indeed
东海龙庭	Dragon Court of the Eastern Seas
龙庭	Dragon Court
无尽	endless, boundless, incessant, infinite, limitless
威严	might, power, prestige, dignity, majestic, awe-inspiring
虚影	shadow, projection
震慑	intimidate, to awe, frighten
势不可挡	unstoppable, irresistable, relentless
茫然	blank, vacant, at a loss
玄妙	abstruse
纠结	dilemma, undecide, grapple, struggle, mixed feelings, unsure
淡漠	indifferent, apathetic, nonchalant
凹陷	caved in, sunken
意料	anticipate, expect
怒吼	(angry) roar, howl, bellow, snarl, rave
挺身而出	step forward bravely, come out boldly
看好	optimistic, bullish, looks promising, good prospect
奇葩	prodigy, weirdo, outlandish
非同凡响	out of the ordinary
草率	sloppy, careless
不可置信	incredulous
心境	state of mind, mental state, mood, frame of mind
运	channel
思索	think deeply, ponder
近在咫尺	close at hand, well within reach, round the corner
所向披靡	sweep away all obstacles, invincible
颤抖	quiver
结巴	stammer, stutter
天道一指	Finger of the Heavenly Dao
啊	ow
湮灭	annihilate, destroy
破天系	Heaven Obliterating Faction
补天系	Heaven Mending Faction
诡异	strange, weird
纠正	rectify
过失	fault, error, negligence
赞许	approve, commend, laud, praise
在意	take notice, care about, mind, take to heart
哎哟	ow, ouch, hey
妄图	futile attempt, try in vain
打击	strike, attack, shock, blow
尴尬	embarrasment
呃	Uh, um
人狗侠侣	Gallant Human and Dog Duo
脱俗	free from vulgarity, refined, outstanding
傲然	grand, majestic, great
言论	remarks, statement, discourse
凶光	menacing, threatening, omnous glint
废物	trash, rubbish, loser, weakling
耻辱	disgrace, shame, humiliation
恐惧	terror, dread, horror
无上	supreme, highest, paramount
无上大道	Paramount Dao
浮现	surface
面对	confront, face
凝固	freeze, solidify, congeal
灌注	pour, gush, rush, surge, stream, teem
蓄	gather
显示	indicate, illustrate
窒息	suffocate, stifle, choke, asphyxiate
狰狞	ferocious, savage, hideous, fierce, sinister, malicious, malign, spiteful, wicked
神情	expression, look
残留	remaining, left over, remnant, surplus
无尽	vast
吞噬	swallow, engulf, gobble up
惊惧	frightened, alarmed, terrified
触目惊心	shocking, startling, astonishing, horrible to see, a ghastly sight
不现实	unreal, surreal
爱慕	adore, admire
神通	remarkable ability, godly ability, supernatural power
心性	disposition, temperament
传神	vivid, lifelike
绝世	exceptional, unique, peerless
风姿	charm, graceful bearing, good looks, good figure
同生共死	go through thick and thin together
盘算	calculatem figure, plan, plot, scheme
同学	student
神威之术	Divine Might
反噬	backlash
嘭	bam
眼皮底下	right before one's eyes
浓稠	thick, dense and creamy
掏	take out, fish out
自爆	self-detonation
锁神冰棺	Soul Locking Ice Coffin
仙器	Immortal Tool
天啊	heavens
后遗症	after-effect
耀眼	eye-catching
耀眼	impressive
杨程武	Yang Chengwu
雄厚	rich, ample, abundant, robust, strong and solid
勇	fearless, brave, valiant, courageous
心神不定	be distracted, feel restless, have no peace of mind
月光轮	Moonlight Disc
仙器	Immortal Weapon
顶尖	best, top-rate, first-rate, peak, finest
镇派之宝	essential treasures
应付	deal with, cope with, handle, make do
金光防护罩	golden defensive barrier
绽放	burst forth, burst into bloom, blossom
灵魂	soul
混沌	chaos
玉杵	jade pestle
噩梦	nightmare
嗯	uh
精元	energy essence
生极造化丹	Ultimate Creation Pill
神魂	conscience
最后	finally, eventually
珍稀	exotic
打死	regardless of what happened
特制武器	Unique Tool
混沌合金砖	Chaotic Alloy Brick
浮空大陆	floating continent
南天门	Northern Heavenly Gate
加固	strengthen
封印	seal
昆仑山	Kunlun Mountain ranges
昆仑	Kunlun Mountain
剿	suppress, put down, destroy, exterminate, annihilate
怪物	monstrosity
渠道	channel, medium of communication, means
半步	Half-Step
动荡	commotion, unrest, turmoil, upheaval
执行	carry out, execute, implement
大腿	coattail
队长	team leader
散发	emanate, emit, impart, ooze
凝聚	form, construct, materialize
一片	vast expanse
神将	Divine General
光合作用	photosynthesize
咧	grimace, grin
慌乱	frenetic, hurried, alarmed and bewildered, panic
挣脱	struggle free of, escape, throw off
慌乱	flustered
谦逊	modest, unassuming, humble
妖宠	Spirit Pet
宠	Pet
道侣	Dao partner
不解	quizzical
脑回路	mind, mindset, thought, frame of mind, mentality
上品	high-grade, top-grade
代购	daigou
戳	jab, poke, stab, sprain, blunt, stamp, seal, prick, chop
折磨	torment, torture
花精	Flower Spirit
不好意思	remorseful
订立	make (a contract)
主仆契约	master and servant contract
订立	sign
契约	contract
妖丹	Spirit Core
危局	dangerous situation
危局	perilous situation
随便	casual, random, informal, careless, slipshod, remiss, wanton, wilful, do as one pleases
嗯	eh
嗯	hmm
算了	so be it
缩	withdraw, pull back, contract, shrink, reduce, draw in
渗	permeate, seep, penetrate, infiltrate
主人	Master
拍马	flatter
哼	humph
化形	transformation
小红	Xiao Hong
娇滴滴	sweet, cute
咦	hm
啜泣	sob
蓉城	Rong City
白云观	Baiyun Temple
凝	become serious
面如土色	ashen-faced, deathly pale
哆嗦	tremble, shiver
哆嗦	quiver
诚哥	Big Brother Cheng
仙术	immortal spell
有关部门	department concerned
黄溪村	Huang Xi Village
离奇	strange, odd, fantastic, bizarre
人心惶惶	state of anxiety
采取	adopt, assume, take, carry out
蔓延	spread, extend, stretch, emanate
田玲玲	Tian Lingling
玲玲	Lingling
假道士	Fake Daoist Priest
不会是	it can't be
阴寒	(cold) chill
特性	special property, unique characteristic
恶鬼	evil spirit
黄珊珊	Huang Shanshan
仙使	immortal ambassadors
噗	pffft
好歹	in any case, at any rate, anyhow
呜	waah
符箓	talisman, charm, ward
踪迹	track, trail, trace
嘶哑	hoarse, husky, coarse
猝不及防	taken by surprise, caught off guard, without warning
理会	take notice of, pay attention to, deal with
咦	hmm
咦	huh
噫	ew
嘤	waah
流氓	hooligan
破邪符	warding seal
剑芒	sword projection, sword aura
咳	ahem
痛苦	pain, suffering, agony
精神	vigour, vitality, drive, spirited, spirit, consciousness, mind, mental state, essence
能量	energy, capability
怒目而视	glowered
怒	glowered
诡异	unusual
得色	smug, cocky, show off
消灭	exterminate, abolish, wipe out, eliminate, perish, die out
轰隆	rumble
挽救	save, remedy, rescue
猛	ferocious, vicious, forceful, aggressive
怜悯	take pity on, mercy, have compassion for, sympathy
识破	seen through
雪王蛛丝	Snow King Cobweb
智慧	wisdom
魔帝	Demon Emperor
国家特别作战部	National Special Operations Department
百目蜘蛛	Hundred-Eyed Spider
智慧魔王	Demon King of Wisdom
全世界修士联合起来一起保护地球	all cultivators of the world unite together to protect earth
木牛道人	Daoist Wooden Ox
真人	Enlightened	Daoist title for one who had attained enlightenment or immortality. (true man, real person, daoist spiritual master)
琉璃真人	Enlightened Lazurite
假道士小安	Fake Daoist Priest Little An
安道友	Daoist An
诱惑	entice, tempt, seduce, lure, attract, allure
金玉子	Golden Jade
装逼	flex
百发百中神算子	Crack Shot Clairvoyant
原子弹仙子	Atomic Bomb Fairy
梦音仙子	Dreamy Voice Fairy
救世主	The Savior
青河剑仙	Green River Sword Immortal
外援	reinforcement
狂风呼啸	the wind howled
牵雷术	Lightning Manipulation Technique
叮咚	Ding Dong
保护地球	protect earth
妖王	Evil Spirit King
尹喜真人	Yi Xi the Enlightened
666	cheer on
密集恐惧症	trypophobia
恐怖	fearsome
独门基础剑法大全	Complete Collection of Sword Technique Basics
探云道人	Cloud Exploring Daoist
痛苦魔王	Demon King of Agony
剑气	sword intent
身死道消	perish
暴怒魔王	Demon King of Wrath
秘术	mystical technique
激光剑	lightsaber
魔改	magical modification
嘲弄	mock, poke fun, tease
修习	practiced
拷问	interrogate
坑	screwed over
韦荣会	Wei Ronghui
牵情酒	captivation wine
林舞华	Lin Wuhua
华国	Hua Country, Hua Nation
郑宏义	Zheng Hongyi
探云道长	Cloud Exploring Daoist
神算子	Crack Shot Clairvoyant
伤痕累累	riddled with wounds
仙丹	immortal pill
道号	Dao title
静心仙女	Calm Celestial Maiden
呕心沥血	underwent infinite hardships
赤蛟道人	Daoist Red Wyrm
皇冠假日酒店	Crown Holiday Hotel
法术	magic spell
龙虎山	Mount Longhu
血令牌	Blood Token
剑宗	Sword Sect
大笑	chortled
黑心魔王	Demon King of Wickedness
智慧兄弟	Brother Wisdom
黑心	Wickedness
变态	freakish, retarded
咸鱼	salted fish, bludger
妖塔	Evil Spirit Tower
血神	Blood God
秘籍	rare text, valuable book
东方雪	Dongfang Xue
大魅惑术	Great Bewitching Technique
化形	shape-shift
娇声	seductive
血族	Blood Tribe
魔族	Demon Tribe
张天师	Heavenly Teacher Zhang
道根	dao foundations
血肉灵碑	Flesh and Blood Spirit Tablet
黑泽	dark marshlands
灵根	spirit root
化神期	Soul Formation Stage
魔王	Demon King
紫星	Purple Star
灵石	spirit stone
日天	f*ck the heavens
噗哇	pwah
安明川	An Mingchuan
道藏	Daoist Scripture
死猪不怕开水烫	nothing to lose
神鉴术	Celestial Identification Technique
鸿达建筑投资有限公司	Hongda Construction and Investment Corporation
修神界面	Cultivation Platform
神威术	Celestial Might Technique
林子	Little Lin
呆立	transfixed
国家修仙部门	National Cultivation Department
震慑	in awe, frighten
小兰	Xiaolan
微言	WeChat
血洗	massacre, slaughter, blood purge
原子弹仙女	Atomic Bomb Fairy
海印方丈	Buddhist Abbot Haiyin
天灵灵	Tian Lingling
血王	Blood King
红狐仙	Red Fox Celestial Maiden
孤傲魔王	Demon King of Arrogance
艾尔文	Erwin
萨留希	Sarus
缅尹	Burmen
洵公馆	Rivers Mansion
兰莉	Riley
卢尼	Loonies
凤凰大街	Phoenix Street
宫城	palatial complex
内城	inner city
外城	outer city
缇德	Teedus Academy
山阴石	Yin Mountain Stone
雅菲帝国	Effer Kingdom
皇家骑士团	Imperial Cavalry Brigade
宫廷法师团	Court Magician Council
曜夜石	Nightglow Stone
凯巴	Kaiba
莱梧	Larwood
宸朱	Chase
隽云	Gwen
瞬发魔法	instant-release spells
《时空法则》	"Laws of Time and Space"
鹰隼	Professor Hawk
费提墨	Professor Hawk
枕剑会	Pillow Sword Tournament
紫荆阁	Redbud Pavilion
魔法盾	magic shield
特拉勒底山脉	Terarody Mountain Ranges
雷萨亲王	Prince Lazaar
攻防课	offense and defense class
光正教	True Light Church
咒术魔法的起源	"The Origins of Arcane Spells"
旧河	Old River Restaurant
希律主教	Archbishop Sirius
庭霄帝国	Skycourt Kingdom
墨焰	Black Blaze
裂空	space split technique
选手看台	contestant's spectating platform
曜影剑阵	Shadowgleam Sword Array
乔芷	Georgina
论魔法的最终伤害	"A Discussion on the Ultimate Damage of Magic"
鹘嘴蜥蜴	Falcon Beak Lizards
天星	Heavenly Star mercenary legion
四方	Four Winds mercenary legion
狼月	Wolf Moon mercenary legion
庭霄	Skycourt Kingdom
大魔导师	grand magic mentor
咒术邪焰黑龙	Arcane Inferno Black Dragon spell
约芬	Joffen
特瓦德丹	Tewadedan
落晶	Fall Crystals
葵倾	Christine
疯猪	Deranged Pig
聂一一	Nie Yiyi
元	Adam
机械军	Mechguard
红蜘蛛	Red Spider
梅	May
胡克	Hook
精神教会	Psychic Church
雷顿	Layton Academy
金莎	Shae
金牙齿	Golden Teeth Incorporated
疯猪	Deranged Pig
本.加西亚	Ben Garcia
金.加西亚	Kim Garcia
金	Kim
精神世界	psychic world
当铺	pawn shop
沙腾市	Sandrise City
召唤	invoke
地狱犬	Hellhound
木乃伊	Mummy
恶魔	anomaly
精神体	psychic body
山本正雄	Masao Yamamoto
雷诺	Layton Academy
金熙照	Kim Hee-cho
灵觉	telegnosis
畸变者	psychic mutant
杀杀狂魔	Lean Mean Killing Machine
八岐大蛇	Yamata no Orochi
百鬼	Hyakki Yagyou
蛇巫	Hebi no Miko
尼德霍格	Níðhöggr
学舟	Ark Learning Children's Fund
秦夜	Qin Ye
灵灾	supernatural disaster
织田信长	Oda Nobunaga
织田信忠	Oda Nobutada
归天蛊铠甲	armaments forged from the carapace of blight vermin
鬼民	netherworldly citizens
离镜宫	Reflection Palace
阴差	Hellguards
阴兽	Yin beasts
蓬丘	Ashmound
射神棺	Soul-Launching Coffin
灭日弩	Sun Vanquishing Crossbow
暗鸠	Dark Dove
鹤独	Lone Crane
六方鬼王	Sixfold Ghost Kings
赵云	Zhao Yun
鬼火	netherworldly fire
鬼火	netherworldly fire
判官	Infernal Judge
鬼差	Netherworld Operative
母衣众	Umamawari
阴气	Yin energy
阴差拿人，闲杂退避	By Hell’s Dictum, all rabble shall disperse
阿落刹娑	Arakshasa
东山	Eastmount Province
徽省	Insignia Province
阿尔萨斯	Arthis
承薪	Everburn
龙胆亮银枪	Courage of Dragons Silver Spear
平西军	West Vanquishing Army
陕西	West Shan Province
威！！	Chaaaaarge!!
八大门阀	Eight Great Clans
吕方	Lü Fang
生死簿	Book of Life and Death
十殿阎罗	Yama-Kings of the 10 Palaces
天界	Heaven
明镜高悬	Mirror of Eminence
阴阳裂隙	Yin Yang Mezzanines
鬼差	Netherworld Operative
拘魂	Soul Hunter
府君	Abyssal Prefects
阎罗	Yama-Kings
彼世安温的魔法炉	Chalice of Preiddeu Annwn
彼世安温	Preiddeu Annwn
阎罗印	King Yanluo's Seal
西都	West Capital
董卓	Dong Zhuo
机关兽	Mechanical Beasts
畜生道主	Daolord of the Beast
青溪县	Clear Creek County
宝安	City of Salvation
阴刺军	Assassins of the Underworld
天狗食月	Moon-Devouring Heavenly Dog
地藏像	Ksitigarbha
地藏像	Ksitigarbha
特别调查处	Special Investigations Department
龙胆亮银枪	Courage of Dragons Silver Spear
结界	Array of the Nine Gods
马海峡	Strait of Tsushima
判官笔	Judgment Pen
六道轮回	six paths of reincarnation
黑夜叉	Black Yaksha
饿鬼道	path of the hungry ghost
封魂球	soul sphere
神器	divine artifact
创造级	creation-grade
羽蛇神	Plumed Serpent God
神血	blood of a divinity
非洲	Alkebulan Underworlds
地府大战	great war of the netherword
西川	Westriver Province
三星堆	Three Star Mound
阴差形态	Hell's Emissary state
烛龙	Aurogon
孟婆	Granny Meng
十八地狱	18 abysses of punishment
六道	six paths of reincarnation
苏妲	Su Daji
秦侩	Qin Hui
大理寺	Imperial Court of Judicial Review
慎刑司	Department of Prudence
天岩户	Amano-Iwato
贵方省	Rich Province
王兽	monarch beast
阴灵	Yin spirit
周瑜	Zhou Yu
十二天罗	twelve envoys
刘裕	Liu Yu
身毒大使	official of Sindhu
高渐离	Gao Jianli
吕蒙	Lü Meng
吕子明	Lü Ziming
谛听	Harken
王成浩	Wang Chenghao
鲁班	Lu Ban
吴道子	Wu Daozi
暴风城	Stormwind City
高长恭	Gao Changgong
大秦王朝	Qin Dynasty
业火神弩	Karmic Fire Divine Crossbows
杨继业	Yang Jiye
吕宋王	Lord of Luzon
圣旨	imperial edict
希腊地府	Argosian Underworld
塔纳托斯	Thanatos
修普诺斯	Hypnos
艾亚哥斯	Aeacus
米诺斯	Minos
拉达曼迪斯	Rhadamanthus
印度地府	Hindustani Underworld
禁术不扩散条约	treaty on the non-proliferation of forbidden arts
华国地府	Cathayan Underworld
不扩散	treaty on the non-proliferation of forbidden arts
神弃之地	forsaken land
阴符	Yin Talismans
李贞淑	Lee Jung-sook
中元节	Hungry Ghost Festival
权景浩	Kwon Kyung-ho
黄家土楼	Huang Clan's earthen building
百鬼夜行	Dusk Legionnaire
刘昌闵	Ryu Changmin
韩国	Daehan
华国	Cathay
灵体	spiritual body
楚人美	Chu Renmei
黄宝坤	Huang Baokun
拆迁	demolition and relocation
黄建森	Huang Jiansen
十恶不赦	irredeemably heinous
太岁	Taisui fungus
护国神卫	Divine Protectors of the country
明妃	Karmamudrā
降魔杵	evil-subduing pestle
卜万田	Bu Wantian
桃花源	Peach Blossom Spring
阴羽	darkfeathers
九州正神结界	Array of the Nine Gods
万宝池	Myriad Treasure Pond
河洛九宫八卦图	Nine Palaces Eight Trigrams Diagram
撼灵堂	Hall of Tremors
莫长浩	Mo Changhao
大狱丸	Otakemaru
叶星辰	Ye Xingchen
女娲	Nüwa
后土娘娘	Goddess Earth Mother
曜变天目碗	Obsidian Heaven’s Eye Bowl
八尺镜	Yata no Kagami
齐女	Qi Nü
轩辕不死印	Yellow Emperor Protector Seal
冥王冥后	Mictlantecutli and Mictetikasiwa
二代	second King Yanluo
日本地府	Nipponese Underworld
东大寺	Tōdai-ji
秦长信	Qin Changxin
伊邪那美	Izanami
素盏鸣尊	Susanoo-no-Mikoto
怀石料理	kaiseki-ryōri
华国	Cathayan Underworld
汤恩娜	Tanvana
奇尔汀	Giltine
耶梦加德	Jörmungandr
北欧	Northern Europa
素盏明尊	Susanoo-no-Mikoto
维拉科查	Viracocha
埃及	Aegyptian Underworld
阿基米德	Archimedes
冥后	Mictetikasiwa
伯爵	Count
特斯卡	Tezcatlipoca
烟雾镜	Tezcatlipoca
阿空加瓜峰	Aconcagua
希帕克特里	Cipactli
朗基努斯	Spear of Longinus
格洛里亚教堂	Gloria Dei Old Swedes Episcopal Church
江崎玲於奈	Reona Esaki
天启大辩论	Great Revelation Debate
二代禁术	second-generation forbidden arts
启动模组	startup module
汤川秀树	Hideki Yukawa
蒋秘书	Secretary Jiang
知更鸟	messgenger bird
布政使	administrative commisioner
城隍庙	City God Temple
轩辕剑主	Sword Master Xuanyuan
地藏	Ksitigarbha
钱多来	Qian Duolai
祖冲之	Zu Chongzhi
公格尔峰	Kongur Tagh
水电站	hydroelectric power station
羲和	Xi He Retirement Home
姚泾明	Yao Jingming
世能研	World Energy Resource Research Organization
伊帕密浓达	Epaminondas
无名死神	nameless god of death
圣安东尼	Archbishop Antonio
藤井平八郎	Heihachiro Fujii
圣宝	Sacred Treasure Consortium
米克特兰提库特里	Mictlantecutli
冥王	Mictlantecutli
阴宙系	Yin Space River
库库尔坎	Quetzalcoatl
坎昆	Cancún
吉得宝	Tepoztli
黑白无常	Black and White Anitya Hellguards
东方明珠	Oriental Pearl Television Tower
大人	Your Excellency
拱手	cupped his fist in a salute
阴差	underworld emissary
阴阳裂缝	Yin Yang Mezzanine
妖鬼仙	demonic ghostly immortals
铁浮屠	heavy cavalry units
万魂塔	Myriad Soul Pagoda
沈田子	Thẩm Điền Tử
朱龄石	Chu Linh Thạch
王镇恶	Vương Trấn Ác
剑礁	Sword Coral Research Institute
阴山格物院	Yin Mountains Research Institute
恭弥	Iwasaki Kyouya
本一郎	Iwasaki Ichiro
竹茂楼	Takeshigerou
岩崎弥太郎	Iwasaki Yatarō
比良坂	Nipponese Underworld
水蛭子	Hiruko
高天原	Takamagahara
歌山三段壁	Sandanbeki Rock Cliff
青木原树海	Aokigahara
天逆每	Amanozako
本多忠胜	Honda Tadakatsu
羽泽城	Feathersheen City
德川家康	Tokugawa Ieyasu
神原康正	Sakakibara Yasumasa
亚太经合会	Asia-Pacific Economic Development Conference
北条时宗	Hōjō Tokimune
丰臣秀吉	Toyotomi Hideyoshi
足利义昭	Ashikaga Yoshiaki
川岛琢磨	Kawashima Takuma
玉藻前	Tamamo-no-Mae
八岐大蛇	Yamata no Orochi
宏野吉泽	Yoshizawa Hiroshi
前田利家	Maeda Toshiie
毛利辉元	Mōri Terumoto
二口女	Futakuchi-onna
大菩提寺	Mahabodhi Temple
阴摩罗	Onmoraki
轮入道	Wanyūdō
耶梦加得	Jörmungandr
天之御中	Minakanushi
烧瓷	pottery firing
朝廷	imperial court
官员	officials
官窑	official kiln
官窑	imperial ware
拉坯	pottery molding
言官	imperial censors
丫鬟	maidservant
贴身丫鬟	personal maidservant
锦衣	brocade robe, brocade-robed
宋集薪	Song Jixin
钱	qian	when referring to silver, one qian is 1/16 of a tael (两)
蛇类	ophidian
四脚蛇	four-legged snake
杏花巷	Apricot Blossom Alley
铁锁井	Iron Lock Well
刘阳羡	Liu Xianyang
大学士	grand secretary
龙窑	dragon kiln
草鞋	straw sandals
玉如意	jade scepter
摸骨	scapulimancy
陈平安	Chen Ping'an
泥瓶巷	Clay Vase Alley
稚圭	Zhi Gui
虬	drake
螭	hornless dragon
蛟	flood dragon
卢正淳	Lu Zhengchun
剑经	sword scripture
宝甲	prized armor
正阳山	Sun Scorch Mountain
廊桥	covered bridge
根骨	aptitude for cultivation
肉眼可见	at a rate disciernible to the naked eye
玄术	profound arts
道法	dao powers
披云山	Cloud Drape Mountain
赵繇	Zhao Yao
紫金	violet gold
顾粲	Gu Can
嫡传弟子	direct disciple
开宗之祖	sect-founding patriarch
下宗	lower sect
云霞山	Dawn Cloud Mountain
云根石	Cloud Root Stone
老龙城	Old Dragon City
蔡金简	Cai Jinjian
苻南华	Fu Nanhua
丹鼎派	alchemy branch of daoism
官话	official dialect
机缘	fated opportunity
齐先生	Mr. Qi
福禄街	Fortune Street
齐静春	Qi Jingchun
大真人	enlightened saints
诸子百家	Hundred Schools of Thought
陆地神仙	terrestrial gods	could be subject to change depending on future context revealed
印章	seal
小千世界	small thousandfold worlds
受教	I humbly accept your teachings
有失身份	unbefitting of someone's status
玉圭	jade tablet
镇圭	regal tablet
金精	gold essence
锦衣少年	brocade-robed boy
暗器	hidden weapon
弋阳郡	Yiyang County
大隋	Great Sui Nation
大宗师	Superior Grandmaster
小宗师	Lesser Grandmaster
高稹	Gao Zhen
大貂寺	chief eunuchs
六科	six supervisory divisions
大骊	Great Li Empire
御马监	Directorate of Imperial Horses
掌印太监	Seal Holding Eunuch
宦官	eunuch
山崖书院	Mountain Cliff Academy
国师	imperial preceptor
桃叶巷	Peach Leaf Alley
浑厚	deep and resonant	when describing voices
邛让	Ruan Qiong
牌坊	archway
碎银	loose silver
槐树	locust tree
槐叶	locust leaf
儒士	scholar
少年	young boy
小镇	small town
中年	middle-aged
根骨	aptitude
东宝瓶洲	Eastern Treasured Vial Continent
大隋王朝	Great Sui Nation
圣人	sage
买瓷人	porcelain buyers
本命瓷	bonded porcelain
瓷镇	porcelain paperweight
舍不得	reluctant
儒家	Confucianism
刘志茂	Liu Zhimao
姚老头	Old Man Yao
说书先生	storyteller
祖荫	ancestral blessing
陆道长	Daoist Lu
铁匠	blacksmith
东宝瓶洲	Eastern Treasured Vial Continent
三教	three teachings
教义	doctrine
道行	Dao foundation
陆沉	Lu Chen
陆道人	Daoist Lu
桃芽	Tao Ya
赶紧	hurriedly
墙外书	Beyond the Wall
曹曦	Cao Xi
县志	Local County Chronicle
婢女	maidservant
谢实	Xie Shi
乡塾	private school
琉璃	colored glaze
宁姚	Ning Yao
真君	True Lord
仙长	Immortal Elder
顾氏	Mrs. Gu
书简湖	Lake Shujian
止境	Halted Realm
神通	mystical power
青峡岛	Cyan Gorge Island
金精铜钱	gold essence copper coins
玉簪子	jade hairpin
小楷	compact script
南涧国	Southern Stream Nation
倒悬山	Stalactite Mountain
道人	Daoist priest
道人	Daoist priest
顽劣	unruly
顽劣	naughty
顽劣	mischievous
顽劣	stubborn
陶罐	clay pot
泥鳅	loach
院子	courtyard
外乡人	outsider
厉色	stern
谄媚	obsequious
谄媚	toadying
铜钱	copper coin
哭笑不得	didn't know whether to laugh or to cry
无常	Reaper of Impermanence
老龙布雨	Old Dragon Rainbringer
门神	door god
春联	couplets
茫然	baffled
放心	relieved
放心	at ease
呜咽	whimper
呜咽	sob
愣	falter
玉簪	jade hairpin
供养钱	Offering Coins
迎春钱	Greeting Spring Coins
压胜钱	Good Fortune Coins
药方	prescription
真人	Spiritual Master
柱国	pillar general
开门	precursor
登堂	beginning
入室	journey
精气神	energy, essence, and spirit
道家真君	True Lord of Daoism
少女	young woman
少女	young girl
笑道	smiled and replied
窑工	potter
杨家铺子	Yang Family's medicine shop
秘方	secret recipe
嘀咕	mumble
嘀咕	grumble
圣人	Saint
圣贤	Sage
圣人	Sage
武道九境	nine tiers of martial arts
武夫	martial artist
龙门境	Dragon Gate Tier
中五境	Middle Five Tiers
沙哑	hoarse
失落	dejected
失落	downcast
失落	despondent
佛陀	Buddha
儒家至圣	Confucius
心虚	guilty
心虚	diffident
阮师傅	Master Ruan
御风	Windsoar Tier
远游	Windsoar Tier
领养钱	adoption money
南海	South Sea
心誓	cardinal vow
清风城	Light Breeze City
瘊子甲	scaly armor
水榭	lakeside pavilion	lakeside in the particular context it's appeared in for me, could be riverside pavilion or just waterside pavilion in general
入室弟子	in-house disciple
藩王	monarch
宋长镜	Song Changjing
搬山老猿	Mountain-moving Ape
风雷园	Wind Lightning Field
文庙	Confucian temple
陪祭	accompanying officiant
陶魁	Tao Kui
纯阳剑祖	Pure Yang Sword Patriarch
督造官衙署	office of the kiln supervision official
督造官	kiln supervision official
衙署	office
门房	porter
观湖书院	Lake View Academy
大雍王朝	Great Yong Empire
龙尾郡	Dragon Tail County
刘灞桥	Liu Baqiao
野修	vagrant cultivator
陈松风	Chen Songfeng
白猿	Bai Yuan
崔明皇	Cui Minghuang
管事	steward
阮邛	Ruan Qiong
宁姑娘	Ning Yao
四大姓	four major clans
匾额	plaque
答非所问	sidestepped the question
答非所问	answered evasively
答非所问	gave an irrelevant answer
巍峨	majestic
白虎	White Tiger
王朱	Wang Zhu
卢家	Lu Clan
沧桑	vicissitudes
嗤笑	sneer
泥塑	clay statue
财迷	miser
帷帽	veiled hat
剑鞘	scabbard
嫌弃	disdain
嫌弃	dislike
小溪	creek
蛇胆石	snake gall pebbles
簪子	hairpin
算命先生	fortune teller
石子	pebble
青色石崖	green stone cliff
石板鱼	rock slate fish
谢家老祖	Patriarch Xie
掌柜	shopkeeper
阮秀	Ruan Xiu
秀儿	Xiu'er
元神	soul
心不在焉	absent-minded
马婆婆	Granny Ma
傻子	retard	for Ma Kuxuan
读书人	intellectual
树墩	tree stump
腼腆	bashful
腼腆	shy
青石板	bluestone slab
皇宫	imperial palace
哭丧	sullen
宋大人	Master Song
晦涩	obscure
大礼	Grand Etiquette
修身篇	Self-Cultivation Chapter
云淡风轻	nonchalant
刘羡阳	Liu Xianyang
丹阳山口	Danyang Mountain Pass
刘临溪	Liu Linxi
隋朝	Great Sui Empire
高氏	Gao Clan
宋氏	Song Clan
宋家	Song Clan
心烦	agitated
心烦	annoyed
压裙刀	skirt dagger
石敢当	shi gandang
陶紫	Tao Zi
捕蛇鹰	snake hunting hawk
李虹	Li Hong
炼气士	qi refiner
子孙槐	descendant locust tree
青牛背	Azure Cow Ridge	Azure Cow Ridge
白猿爷爷	Grandpa Yuan
李家	Li Clan
卢氏	Lu Clan
道姑	Daoist nun
法器	immortal tool
法宝	immortal treasure
法术	spell technique
法力	immortal powers
法门	immortal formulation
甘草	licorice root
许家	Xu Clan
小姐	Young Mistress
上五境	Upper Five Tiers
风生水起	Rising Winds Crashing Water	for the plaque on the bridge
青石	bluestone slab
神仙	immortal
陈氏	Chen Clan
黄油纸	parchment paper
撼山	Mountain Shaking
撼山谱	Mountain Shaking Guide
敷衍	perfunctory
玉玺	jade seal
福地	blessed land
符剑	talismanic sword
陈对	Chen Dui
楼	Tier	for cultivation tiers, i.e. Sixth Tier
江湖	cultivation world
截江真君	River Severing True Lord
拳谱	fist technique
十境	10th Tier
棋待诏	Go official
绣虎	Embroidered Tiger
炼体境	Physique Refining Tier
天劫	tribulation
雷劫液	Lightning Tribulation Fluid
圆满	consummate	For Ascending Origin Tier
炼气	Qi Refining Tier
炼体	Physique Refining Tier
炼神	Spirit Refining Tier
炼体三境	three tiers of the Physique Refining Tier
气	Qi
武道	martial arts
悟性	comprehension ability
木胎境	Wooden Fetus Tier
水银镜	Mercury Tier
泥菩萨过江	Mud Deity Crossing the River	name for tribulation
窍穴	acupoint
读书人	scholar
玉牌	jade tablet
书院	academy
护经师	Dharmapala
静心得意	Tranquil Mind Begets Enlightenment
陈十一	Chen Shiyi
龙兴之地	origin of a dynasty
符箓	talisman
锁龙井	Dragon Locking Well
深潭	deep pool	under the covered bridge
百家	hundred schools of thought
师侄	Martial Nephew, Martial Niece
道冠	Daoist hat
小女孩	little girl
贺小凉	He Xiaoliang
金童玉女	Golden Boy and Jade Girl	for the Daoist priest and nun
道家	Daoist Sect
马苦玄	Ma Kuxuan
真武山	True Martial Mountain
僧人	monk
苦行僧	ascetic monk
雷音塔	Thundering Pagoda
天师印	Heavenly Master Seal
小剑冢	Small Sword Resting Ground
兵家	Martial Sect
山岳玉牌	Mountain Range Jade Plate
儒家	Confucian Sect
压胜之物	subjugation treasures
武人	martial artist
万	tens of thousands
站桩	standing meditation
走桩	walking meditation
睡桩	sleeping meditation
元气	vital energy
元气	vigour
立桩	standing meditation
剑炉	Sword Furnace	for standing meditation
千秋	Eternity	for sleeping meditation
末法	degenerate age of Dharma
天师	Heavenly Master
护法	Dharmapala
大德	Bhadanta
水观心境	Observing Water Mental State
剑修	swordsman
拳意	fist intent
搬山猿	Mountain-moving Ape
。	Chen Ping'an	author is retarded
老猿	Bai Yuan
护山猿	Bai Yuan
本命	bonded
大骊藩王	Song Changjing
少女	Ning Yao
老杨头	Old Man Yang
敕令仪式	Edict Ceremony
灵官	Enforcer	Daoist position
玉枕	Jade Pillow
天柱	Celestial Pillar
祖庭	Ancestral Temple
大道之敌	Dao enemy
神道	Divine Dao
礼乐	Ritual and Music System
兵家修士	martial artist
骑龙巷	Dragon Riding Alley
压衣刀	skirt dagger
无垢之躯	Untainted Physique
斩龙台	Dragon Slaying Platform
磨剑石	sword whetstone
磨刀石	saber whetstone
养剑葫	Sword Nurturing Gourd
术法	mystical ability
守墓人	graveyard attendent
薛管事	Steward Xue
搬柴哥哥	firewood collecting brother
猿爷爷	Grandpa Yuan
天材地宝楼	Treasure Pagoda
境界	cultivation base
道士	Daoist priest
书童	scholarly attendant
亚圣	Second Sage
本命字	kindred character
山主	mountain master
三学宫	three schools
宝瓶洲	Eastern Treasured Vial Continent
泥丸穴	Mud Pellet acupoint
阮师	Master Ruan
兵家	martial artists
海潮铁骑	Sea Tide Cavalry
杨老先生	Mr. Yang
杨老头	Old Man Yang
郑大风	Zheng Dafeng
神通	mystical ability
妖	demon
魔	demon
鬼	ghost
怪	monster
兵	pawn
将	general
帝	emperor
饕餮	Taotie
飞升境	Ascension Tier
李二	Li Er
金刚不败	indestructible vajra
书箱	bookcase
清明节	Tomb Sweeping Festival
骊珠	Jewel Small World
道君	Dao Lord
道貌岸然	sanctimonious
功德坊	merit archway
功名坊	scholarly honor archway
学宫书院坊	academy archway
刘家	Liu Clan
天君	Heavenly Lord
阴德	hidden virtue
谱牒	genealogical records
老妪	old woman	if referring to river guardian, this is Granny Ma
天命所归	Mandate of Heaven
龙王篓	Dragon King Basket
铁匠铺	blacksmith shop
草头	Burclover
颍阴陈氏	Yingyin Chen Clan
桃源洞天	Paradise Small World
罡风洞天	Astral Winds Small World
须弥芥子	all-encompassing seed
袖有乾坤	world up the sleeve
神剑	divine sword
剑芒	sword ray
神兵	divine weapon
雷池剑阵	Lightning Field Sword Formation
苏稼	Su Jia
许氏	Xu Clan
颍阴陈氏	Yingyin Chen Clan
洞天	mystical realm
洞天	small world	i used these two interchangeably
剑仙	sword immortal
河神	river god
江神	great river god
水精	water essence
李宝瓶	Li Baoping
石春嘉	Shi Chunjia
山水印	Mountain and Water Seals
神庭	Divine Court
巨阙	Giant Tower
太渊	Great Void
天生火神之体	innate fire god constitution
火神之体	fire god constitution
证道契机	Dao attainment catalyst
五岳	Five Mountains
皇都	imperial capital
皇兄	imperial brother
散气	Qi dispersion
养气	Qi development
龙头山	Dragon Head Mountain
练气士	Qi refiner
法器	artifact
止境	End Tier	for 10th tier of martial arts
龙泉县	Dragon Spring County
龙脊山	Dragonspine Mountain
风雪庙	Wind Snow Temple
吴鸢	Wu Yuan
武圣庙	martial sage temple
地师	fengshui master
钦天监	official of astronomy
神仙坟	immortal tomb
膻中	Danzhong
山岳大神	great mountain god
真珠山	True Jewel Mountain
神秀山	Divine Elegance Mountain
挑灯山	Lamp Bearer Mountain
横槊峰	Gallant Spear Mountain
城隍阁	city god pavilion
仙草山	Immortal Herb Mountain
宝箓山	Treasured Scripture Mountain
彩云峰	Rainbow Cloud Mountain
点灯山	Lamp Bearer Mountain
落魄山	Downtrodden Mountain
落魄山	Downtrodden Mountain
崔瀺	Cui Chan
风雷笺	Wind Lightning Sheet
崔瀺	Cui Chan
宋煜章	Song Yuzhang
墨家	Mohism
墨家巨子	leading figures of Mohism
董水井	Dong Shuijing
林守一	Lin Shouyi
李槐	Li Huai
文圣	Scholarly Sage
葫	gourd
四姓十族	Four Families and Ten Clans
阿良	A'Liang
土地	mountain lord	for the guy at Go Table Mountain because Mountain God is different i think
棋墩山	Go Table Mountain
土地	earth lord
魏檗	Wei Bo
蛇蟒	python
朱河	Zhu He
朱鹿	Zhu Lu
横宝阁	horizontal treasure pagoda
红烛镇	Red Candle Town
朱叔叔	Uncle Zhu
铁符河	Iron Talisman River
山神	mountain god
英灵	heroic spirit
驿站	postal station
秘境	mystical realm
竹海洞天	Bamboo Sea Small World
神水国	Divine Water Nation
冲澹江	Rushing Tranquil River
年轻土地	Wei Bo	mountain lord of Go Table Mountain
竹夫人	Lady Zhu
小洞天	small world
大洞天	large world
岛屿洞天	Island Small World
吞岛鲸	island-engulfing whale
青神山	Azure Divine Mountain
功德簿	merit register
道德林	forest of morality
青乌先生	Mr. Qingwu
江神	river god
钦天监	Ministy of Astronomy
礼部	Ministry of Rites
二郎巷	Erlang Alley
青童天君	Azure Child Heavenly Lord
地官	earth official
散气	qi dispersion
仙竹	celestial bamboo
泥胚境	Clay Embryo Tier
兵家修士	martial arts cultivator
奋勇竹	courage bamboo
正神	formal god
剑气	sword qi
道意	Dao intent
猛字楼	The Fierce Building
李柳	Li Liu
藩王	feudal lord
小师叔	junior uncle
阴神	Yin god
龙须溪	Dragon Whisker Creek
云上琅琅书	Recite Atop Clouds Scripture
祥符	Auspicious Talisman	the saber's name
英雄胆	Hero's Gall Pill
紫气书	Purple Qi Guide
练气士	cultivator
兵家修士	weapons cultivator	i always get parts were this is explicitly used to contrast with martial artist
杏花春	apricot blossom wine
绣花江	Embroidered Flower River
程昇	Cheng Sheng
枕头驿	Pillow Relay Station
驿丞	relay station deputy
县令	county magistrate
唐树头	Tang Shutou
驿丞	Cheng Sheng	dude at Red Candle Town
桃花春烧	spring peach blossom wine
敷水湾	Fu Inlet
船家女	boat women
玉液江	Fine Wine River
画舫	decorated boat
天华元宝	Heavenly Brilliance Ingots
观水街	River Viewing Street
驿路	post road
山水游记	travel journal
断水大崖	Severed Water Cliff
蠹鱼	silverfish
二公子	Second Young Master
文昌阁	Wenchang pavilion
竹叶亭	Bamboo Leaf Pavilion
神水王朝	Divine Water Nation
河婆	river guardian	this sometimes refers to Granny Ma
野夫关	Yefu Pass
馒头山	Steamed Bun Mountain
李锦	Li Jin
郎中	palace minister	actually dont know, cant find shit about it
员外郎	external official
吏部	Ministry of Personnel
祭清吏司	Ritual Office
龙须河	Dragon Whisker River
铁符江	Iron Talisman River
青冥鱼	green darkness fish
神仙姐姐	Big Sister Immortal
十八停	Eighteen Stops
王毅甫	Wang Yifu
长春宫	Palace of Eternal Spring
五雷正法	Five Lightning Righteous Technique
魏晋	Wei Jin
水符王朝	Water Talisman Empire
